id_facture,nom_du_client,create_date,due_in_date,clear_date,montant_totale,totale_payer,totale_reste
500001,Company_1,2021-02-18,2021-05-21,2021-09-27,10860,20,10840
500002,Company_1,2023-11-01,2023-12-08,2024-06-05,9576,400,9176
500003,Company_1,2022-04-11,2022-06-25,2022-11-24,12761,10372,2389
500004,Company_1,2021-02-21,2021-05-10,2021-07-30,15777,9625,6152
500005,Company_1,2020-06-15,2020-09-26,2021-01-14,18597,18483,114
500006,Company_1,2022-07-16,2022-09-17,2023-04-01,18735,16170,2565
500007,Company_1,2020-11-11,2021-01-19,2021-07-13,19413,15856,3557
500008,Company_1,2022-05-28,2022-07-17,2022-08-23,5812,4232,1580
500009,Company_1,2020-06-10,2020-08-08,2021-01-14,2660,1538,1122
500010,Company_1,2020-06-15,2020-08-10,2021-02-07,10973,8489,2484
500011,Company_1,2022-10-05,2022-11-26,2023-01-09,5446,650,4796
500012,Company_1,2020-02-26,2020-05-02,2020-05-27,13825,2932,10893
500013,Company_1,2020-05-06,2020-08-06,2021-01-14,5007,3397,1610
500014,Company_1,2021-05-04,2021-07-05,2021-12-27,23593,3304,20289
500015,Company_1,2022-10-21,2022-12-16,2022-12-24,17941,11253,6688
500016,Company_1,2022-06-17,2022-09-05,2022-12-28,5526,2976,2550
500017,Company_2,2020-01-26,2020-03-18,2020-09-03,22817,10820,11997
500018,Company_2,2022-01-08,2022-02-14,2022-04-22,17999,752,17247
500019,Company_2,2021-11-09,2022-01-08,2022-03-01,11163,8345,2818
500020,Company_2,2020-09-12,2020-10-23,2021-01-04,4546,677,3869
500021,Company_3,2021-12-20,2022-01-24,2022-05-07,3480,901,2579
500022,Company_3,2022-07-19,2022-10-12,2022-11-12,14956,12322,2634
500023,Company_3,2023-07-31,2023-09-18,2023-11-12,11397,3851,7546
500024,Company_3,2021-06-30,2021-08-07,2021-11-20,12775,10234,2541
500025,Company_3,2023-12-26,2024-01-29,2024-08-01,13926,3323,10603
500026,Company_3,2022-08-31,2022-09-30,2022-12-27,9633,4035,5598
500027,Company_3,2020-11-12,2021-01-14,2021-01-14,23367,4614,18753
500028,Company_3,2023-06-04,2023-08-11,2023-09-06,23018,11917,11101
500029,Company_3,2021-11-26,2022-03-15,2022-04-15,1478,654,824
500030,Company_3,2021-12-24,2022-04-02,2022-08-31,14289,633,13656
500031,Company_4,2022-06-10,2022-09-08,2022-10-02,20295,8225,12070
500032,Company_4,2021-01-22,2021-03-23,2021-07-09,3303,67,3236
500033,Company_4,2022-05-02,2022-05-19,2022-09-08,22342,21317,1025
500034,Company_5,2022-11-23,2023-03-21,2023-06-24,4160,2390,1770
500035,Company_5,2021-10-26,2021-12-08,2022-05-13,19734,10282,9452
500036,Company_5,2023-10-25,2023-11-17,2024-05-27,20053,9242,10811
500037,Company_5,2023-06-03,2023-09-30,2023-12-16,21271,12965,8306
500038,Company_5,2022-12-31,2023-04-14,2023-07-06,24923,12544,12379
500039,Company_5,2022-07-22,2022-09-03,2022-12-21,23980,22924,1056
500040,Company_5,2022-08-10,2022-10-12,2023-03-04,24091,21840,2251
500041,Company_5,2020-10-31,2020-11-17,2021-04-21,22572,1345,21227
500042,Company_5,2022-04-29,2022-07-19,2022-10-12,5141,4833,308
500043,Company_5,2020-12-19,2021-04-10,2021-05-12,3247,548,2699
500044,Company_5,2020-05-06,2020-08-30,2020-12-27,20754,10729,10025
500045,Company_6,2020-03-11,2020-05-27,2020-06-18,12187,11389,798
500046,Company_6,2022-01-26,2022-02-10,2022-03-13,14091,13129,962
500047,Company_6,2022-10-23,2023-02-12,2023-02-28,1946,1043,903
500048,Company_6,2022-08-25,2022-12-05,2023-05-08,8675,173,8502
500049,Company_6,2020-12-12,2021-01-10,2021-07-24,5270,3300,1970
500050,Company_6,2020-03-22,2020-04-24,2020-05-14,13532,10342,3190
500051,Company_6,2020-06-21,2020-08-21,2020-09-03,7868,4388,3480
500052,Company_6,2020-11-10,2021-02-21,2021-05-12,15509,8029,7480
500053,Company_6,2020-10-06,2020-10-25,2021-03-30,7084,1855,5229
500054,Company_6,2021-12-18,2022-02-14,2022-07-06,6882,5519,1363
500055,Company_6,2022-07-12,2022-09-13,2023-01-04,13829,827,13002
500056,Company_6,2022-11-23,2023-01-23,2023-08-07,7628,2224,5404
500057,Company_6,2022-07-20,2022-08-06,2022-10-23,1344,640,704
500058,Company_6,2020-03-14,2020-04-17,2020-08-04,21474,7209,14265
500059,Company_6,2020-03-13,2020-05-10,2020-07-31,4095,2241,1854
500060,Company_6,2023-02-08,2023-05-26,2023-07-29,7700,3163,4537
500061,Company_7,2023-10-23,2023-12-09,2024-03-10,9124,7929,1195
500062,Company_7,2020-02-07,2020-04-25,2020-09-02,5975,5302,673
500063,Company_7,2021-08-21,2021-11-04,2022-04-27,16561,14394,2167
500064,Company_8,2021-09-04,2021-09-30,2022-03-08,15684,14814,870
500065,Company_8,2020-05-25,2020-07-11,2020-11-09,7491,3714,3777
500066,Company_8,2021-03-15,2021-06-11,2021-06-29,8757,3150,5607
500067,Company_8,2022-12-30,2023-03-02,2023-08-24,11852,5803,6049
500068,Company_8,2022-09-04,2022-11-10,2022-12-31,15792,2115,13677
500069,Company_8,2023-10-21,2024-02-14,2024-08-21,3576,3404,172
500070,Company_8,2020-09-02,2020-11-27,2020-12-28,24328,10770,13558
500071,Company_8,2021-06-26,2021-09-10,2022-01-28,3194,177,3017
500072,Company_8,2022-01-21,2022-04-05,2022-09-15,13006,10361,2645
500073,Company_8,2022-06-12,2022-09-04,2023-03-02,803,399,404
500074,Company_8,2023-09-20,2023-11-26,2024-02-07,2560,1899,661
500075,Company_8,2020-11-28,2021-03-24,2021-09-03,20260,13713,6547
500076,Company_8,2020-06-30,2020-09-11,2021-03-20,7830,1877,5953
500077,Company_9,2021-04-10,2021-06-05,2021-08-24,18393,16354,2039
500078,Company_9,2023-10-30,2024-01-28,2024-07-17,7704,3698,4006
500079,Company_9,2021-04-14,2021-08-10,2021-12-07,9260,3802,5458
500080,Company_9,2021-08-12,2021-08-26,2022-02-13,20715,13843,6872
500081,Company_10,2020-10-01,2021-01-28,2021-05-12,22314,17018,5296
500082,Company_10,2022-04-08,2022-05-13,2022-06-21,13231,6265,6966
500083,Company_10,2022-03-06,2022-06-15,2022-08-05,23688,383,23305
500084,Company_10,2023-08-21,2023-10-31,2024-04-29,2711,247,2464
500085,Company_10,2023-10-10,2023-12-30,2024-03-07,24260,4339,19921
500086,Company_11,2023-04-29,2023-07-15,2023-12-11,24333,14940,9393
500087,Company_11,2020-06-11,2020-06-23,2020-07-13,24087,1021,23066
500088,Company_11,2023-12-18,2023-12-28,2024-01-11,17815,7132,10683
500089,Company_11,2020-06-27,2020-09-03,2021-03-16,16580,5357,11223
500090,Company_11,2021-11-05,2022-02-14,2022-07-20,12688,11253,1435
500091,Company_11,2020-01-26,2020-04-07,2020-10-16,4490,772,3718
500092,Company_11,2023-09-19,2023-10-24,2024-02-20,18876,6950,11926
500093,Company_11,2020-02-09,2020-05-09,2020-05-15,11704,3210,8494
500094,Company_11,2020-07-15,2020-07-28,2020-08-18,4181,3346,835
500095,Company_11,2020-01-24,2020-04-12,2020-10-10,1367,1087,280
500096,Company_12,2022-04-16,2022-07-03,2022-12-23,3621,2700,921
500097,Company_12,2024-01-26,2024-03-22,2024-08-20,4038,68,3970
500098,Company_12,2022-11-15,2023-03-05,2023-05-12,24375,3113,21262
500099,Company_12,2022-03-08,2022-06-22,2022-11-06,13840,5839,8001
500100,Company_12,2023-01-30,2023-03-14,2023-03-23,6779,1475,5304
500101,Company_12,2022-03-15,2022-03-30,2022-10-09,1974,718,1256
500102,Company_12,2021-01-23,2021-02-14,2021-04-09,12627,2255,10372
500103,Company_12,2023-12-24,2024-02-02,2024-06-07,21629,1796,19833
500104,Company_12,2022-03-21,2022-04-15,2022-06-24,13287,271,13016
500105,Company_12,2023-01-26,2023-04-18,2023-04-27,20002,513,19489
500106,Company_12,2020-11-22,2021-01-15,2021-02-20,12030,6303,5727
500107,Company_12,2021-10-26,2021-11-07,2022-05-14,13216,7293,5923
500108,Company_12,2021-01-29,2021-05-03,2021-08-16,14056,2520,11536
500109,Company_12,2023-09-27,2023-11-13,2024-03-13,17507,8934,8573
500110,Company_12,2023-06-19,2023-09-14,2024-03-24,21644,9363,12281
500111,Company_12,2023-11-04,2023-12-31,2024-03-20,5182,2743,2439
500112,Company_12,2024-01-04,2024-01-30,2024-04-16,17194,2397,14797
500113,Company_12,2023-05-25,2023-09-01,2024-02-03,20252,7259,12993
500114,Company_12,2022-06-06,2022-09-01,2023-02-24,19454,19118,336
500115,Company_13,2023-02-16,2023-05-09,2023-09-18,4067,340,3727
500116,Company_13,2021-01-28,2021-03-19,2021-08-16,23505,8671,14834
500117,Company_13,2023-01-08,2023-03-13,2023-08-26,8754,7588,1166
500118,Company_13,2020-06-11,2020-09-24,2021-03-24,9267,1448,7819
500119,Company_13,2021-01-18,2021-02-23,2021-08-08,17110,10803,6307
500120,Company_13,2023-05-21,2023-07-30,2023-08-03,10504,7331,3173
500121,Company_14,2021-02-18,2021-04-18,2021-06-11,19609,3009,16600
500122,Company_14,2023-02-08,2023-05-26,2023-10-03,15167,10528,4639
500123,Company_14,2022-12-24,2023-04-08,2023-06-22,20403,5990,14413
500124,Company_14,2024-01-16,2024-05-07,2024-08-09,15056,7038,8018
500125,Company_14,2023-08-02,2023-11-12,2024-04-25,7183,1981,5202
500126,Company_15,2021-06-12,2021-08-12,2022-01-29,4414,2298,2116
500127,Company_15,2023-06-18,2023-08-06,2023-08-19,6772,2161,4611
500128,Company_15,2021-01-29,2021-04-25,2021-10-30,12190,5975,6215
500129,Company_15,2021-07-12,2021-10-14,2022-03-23,5328,3111,2217
500130,Company_15,2023-11-29,2024-02-23,2024-07-10,10642,8395,2247
500131,Company_15,2020-07-21,2020-10-31,2020-12-02,22780,14439,8341
500132,Company_16,2022-01-04,2022-04-19,2022-08-12,10237,612,9625
500133,Company_16,2021-02-17,2021-05-24,2021-10-12,20958,14787,6171
500134,Company_16,2022-09-10,2022-12-11,2023-05-23,22962,6487,16475
500135,Company_16,2020-01-26,2020-03-21,2020-06-29,7432,3007,4425
500136,Company_16,2021-09-21,2021-11-30,2022-06-11,15728,9063,6665
500137,Company_16,2023-01-05,2023-02-04,2023-08-22,2621,948,1673
500138,Company_16,2021-07-09,2021-10-13,2022-02-19,1746,1740,6
500139,Company_16,2023-08-23,2023-10-11,2023-11-10,16403,15912,491
500140,Company_16,2022-04-22,2022-06-05,2022-09-08,19942,1200,18742
500141,Company_16,2023-11-15,2024-01-10,2024-02-08,5938,2102,3836
500142,Company_16,2022-02-04,2022-05-21,2022-05-27,15143,5551,9592
500143,Company_16,2020-08-13,2020-09-08,2020-12-04,12083,369,11714
500144,Company_16,2021-03-30,2021-07-26,2022-01-05,8091,5239,2852
500145,Company_16,2023-06-30,2023-08-13,2024-02-22,1923,699,1224
500146,Company_16,2021-05-26,2021-07-06,2021-08-04,16514,15779,735
500147,Company_16,2023-01-15,2023-04-01,2023-07-01,22084,16312,5772
500148,Company_17,2023-06-25,2023-09-27,2023-11-27,24071,22669,1402
500149,Company_17,2024-01-23,2024-04-17,2024-09-14,6943,3421,3522
500150,Company_17,2024-01-02,2024-03-18,2024-06-07,9509,7519,1990
500151,Company_17,2023-02-12,2023-05-22,2023-07-05,12407,11558,849
500152,Company_17,2020-02-26,2020-04-09,2020-05-12,10270,4687,5583
500153,Company_17,2024-01-24,2024-02-04,2024-03-17,2727,1738,989
500154,Company_17,2021-07-25,2021-08-06,2021-08-30,10071,61,10010
500155,Company_17,2022-01-02,2022-03-07,2022-07-23,15067,12414,2653
500156,Company_17,2021-04-22,2021-07-30,2021-08-18,11992,3521,8471
500157,Company_17,2020-10-17,2020-11-15,2021-04-04,20263,12641,7622
500158,Company_17,2021-04-06,2021-07-28,2021-10-02,21299,19214,2085
500159,Company_17,2022-12-19,2023-03-29,2023-04-25,23531,6319,17212
500160,Company_17,2021-11-21,2021-12-11,2022-01-23,10211,1614,8597
500161,Company_17,2022-04-24,2022-07-11,2022-12-25,8995,3819,5176
500162,Company_17,2021-06-27,2021-10-06,2021-12-06,14267,878,13389
500163,Company_18,2023-03-12,2023-05-26,2023-09-23,14197,1229,12968
500164,Company_18,2022-07-27,2022-10-17,2023-02-03,13490,8990,4500
500165,Company_18,2021-10-01,2021-11-14,2022-05-14,11039,7658,3381
500166,Company_18,2021-06-01,2021-08-09,2022-02-01,19786,12748,7038
500167,Company_19,2020-12-18,2021-01-29,2021-05-02,19811,9582,10229
500168,Company_19,2022-08-29,2022-11-09,2022-11-11,13124,198,12926
500169,Company_19,2020-11-01,2020-11-16,2021-05-16,21123,12337,8786
500170,Company_19,2023-07-10,2023-10-08,2023-12-23,808,462,346
500171,Company_19,2020-05-21,2020-08-03,2020-11-26,24838,51,24787
500172,Company_19,2023-04-01,2023-07-07,2023-12-15,24620,18142,6478
500173,Company_19,2023-09-17,2023-10-25,2024-01-14,11498,2992,8506
500174,Company_20,2023-10-29,2024-01-08,2024-04-25,20285,6206,14079
500175,Company_20,2023-03-12,2023-04-26,2023-06-13,20322,15145,5177
500176,Company_20,2021-01-06,2021-02-23,2021-07-28,18236,11315,6921
500177,Company_20,2020-08-19,2020-12-09,2021-01-05,24850,1343,23507
500178,Company_20,2022-07-25,2022-08-07,2022-11-08,10244,7661,2583
500179,Company_20,2023-04-18,2023-05-15,2023-05-30,21527,12245,9282
500180,Company_20,2024-01-24,2024-03-10,2024-04-15,17087,9463,7624
500181,Company_20,2022-10-06,2023-01-16,2023-07-26,17639,12273,5366
500182,Company_20,2021-05-12,2021-07-20,2021-12-08,818,446,372
500183,Company_20,2022-05-12,2022-08-03,2022-12-12,15974,13772,2202
500184,Company_20,2022-09-01,2022-10-22,2022-11-06,22652,13911,8741
500185,Company_20,2021-12-17,2022-04-01,2022-06-19,23741,4916,18825
500186,Company_20,2021-04-01,2021-06-23,2021-12-26,13020,12373,647
500187,Company_20,2020-02-19,2020-05-27,2020-12-08,15041,12908,2133
500188,Company_20,2023-12-19,2024-03-21,2024-06-19,22680,16365,6315
500189,Company_21,2022-04-18,2022-07-20,2022-12-18,10890,6834,4056
500190,Company_21,2020-10-02,2020-12-16,2021-02-25,4900,793,4107
500191,Company_21,2022-11-23,2023-02-04,2023-03-14,22362,349,22013
500192,Company_21,2020-01-25,2020-03-31,2020-08-14,15461,2945,12516
500193,Company_21,2023-04-28,2023-07-06,2023-11-30,19222,860,18362
500194,Company_21,2021-04-24,2021-08-10,2021-09-16,1277,621,656
500195,Company_21,2022-09-08,2022-10-04,2023-02-08,23117,1145,21972
500196,Company_21,2022-09-30,2022-12-15,2023-04-03,15405,4246,11159
500197,Company_21,2020-03-20,2020-05-05,2020-06-18,2919,668,2251
500198,Company_21,2023-04-11,2023-06-10,2023-09-16,18387,9665,8722
500199,Company_21,2021-02-19,2021-04-17,2021-09-11,18692,14859,3833
500200,Company_21,2021-06-25,2021-08-31,2021-10-03,4388,295,4093
500201,Company_21,2021-05-08,2021-08-22,2021-09-05,2969,674,2295
500202,Company_21,2020-01-11,2020-03-11,2020-09-24,11128,1577,9551
500203,Company_21,2022-12-26,2023-02-15,2023-04-26,8193,3665,4528
500204,Company_21,2022-05-05,2022-07-16,2022-08-14,23948,9102,14846
500205,Company_21,2020-05-02,2020-06-15,2020-10-12,24280,11579,12701
500206,Company_22,2023-03-12,2023-06-13,2023-06-17,15937,3608,12329
500207,Company_22,2021-10-31,2022-01-29,2022-04-29,20965,11530,9435
500208,Company_22,2020-08-10,2020-10-22,2021-03-18,12697,11810,887
500209,Company_22,2024-01-13,2024-04-01,2024-09-12,5434,876,4558
500210,Company_22,2022-03-09,2022-06-24,2022-11-21,21699,11826,9873
500211,Company_22,2022-08-07,2022-10-02,2022-11-23,14069,2504,11565
500212,Company_22,2021-10-01,2022-01-17,2022-06-24,24184,2651,21533
500213,Company_22,2020-11-30,2021-01-31,2021-04-10,4378,2302,2076
500214,Company_22,2020-10-22,2020-11-23,2021-04-04,17891,3857,14034
500215,Company_22,2020-04-13,2020-05-16,2020-06-10,5918,405,5513
500216,Company_23,2022-09-02,2022-12-29,2023-05-14,5335,2965,2370
500217,Company_23,2022-02-04,2022-04-06,2022-05-04,12539,3656,8883
500218,Company_23,2021-04-03,2021-05-27,2021-12-09,3383,376,3007
500219,Company_23,2021-03-01,2021-04-24,2021-05-06,4556,2512,2044
500220,Company_23,2022-04-20,2022-06-03,2022-07-30,8307,7949,358
500221,Company_23,2020-07-31,2020-09-22,2021-03-06,23441,22770,671
500222,Company_23,2022-10-21,2022-12-11,2023-02-21,11765,5367,6398
500223,Company_23,2021-07-31,2021-08-31,2021-09-30,21314,2375,18939
500224,Company_24,2021-12-21,2022-01-10,2022-02-17,5942,3469,2473
500225,Company_24,2024-01-26,2024-05-10,2024-10-25,13830,4588,9242
500226,Company_24,2023-05-15,2023-08-11,2024-02-07,8680,8298,382
500227,Company_24,2022-10-27,2022-12-28,2023-03-26,23194,3559,19635
500228,Company_24,2022-06-25,2022-10-02,2023-04-14,10936,4208,6728
500229,Company_24,2022-08-07,2022-09-29,2023-02-13,7430,5738,1692
500230,Company_24,2023-01-14,2023-05-12,2023-06-30,14994,13850,1144
500231,Company_24,2023-03-29,2023-04-16,2023-08-17,4346,606,3740
500232,Company_24,2020-06-30,2020-09-09,2020-10-02,20343,17922,2421
500233,Company_24,2022-03-08,2022-07-01,2022-09-20,14126,11282,2844
500234,Company_24,2021-04-28,2021-07-26,2021-07-27,1162,164,998
500235,Company_25,2023-01-15,2023-04-26,2023-05-11,7520,7074,446
500236,Company_25,2021-09-01,2021-10-18,2021-12-28,20406,19555,851
500237,Company_25,2022-01-26,2022-05-07,2022-06-07,7115,1604,5511
500238,Company_25,2020-07-18,2020-11-06,2020-11-22,1344,89,1255
500239,Company_25,2021-01-16,2021-02-28,2021-06-20,10869,7314,3555
500240,Company_25,2022-01-23,2022-03-29,2022-04-01,17056,5213,11843
500241,Company_25,2022-07-25,2022-10-31,2023-05-14,17936,2678,15258
500242,Company_25,2020-01-12,2020-04-06,2020-07-28,23241,6392,16849
500243,Company_25,2023-07-28,2023-09-02,2023-11-01,7413,3937,3476
500244,Company_25,2021-09-15,2021-12-28,2022-04-05,15872,6205,9667
500245,Company_25,2022-11-30,2023-03-04,2023-06-22,17491,1982,15509
500246,Company_25,2020-11-30,2020-12-27,2021-07-13,15035,5555,9480
500247,Company_25,2021-08-02,2021-10-02,2022-03-14,14217,12510,1707
500248,Company_26,2020-08-20,2020-09-22,2020-12-14,21916,6786,15130
500249,Company_26,2021-09-25,2021-12-12,2022-05-26,7615,6522,1093
500250,Company_26,2020-06-22,2020-09-28,2021-04-15,16843,7351,9492
500251,Company_26,2021-08-03,2021-09-21,2022-03-04,6784,3123,3661
500252,Company_27,2021-05-21,2021-06-20,2021-07-26,20823,6039,14784
500253,Company_27,2021-10-21,2022-01-02,2022-07-20,13313,8616,4697
500254,Company_27,2023-10-13,2023-12-24,2024-05-22,13081,5211,7870
500255,Company_27,2021-09-21,2021-12-29,2022-05-24,21090,1006,20084
500256,Company_27,2021-09-25,2021-11-01,2022-01-20,18360,8259,10101
500257,Company_27,2020-09-21,2020-10-02,2021-02-22,1771,949,822
500258,Company_27,2023-12-30,2024-02-12,2024-07-05,7798,516,7282
500259,Company_27,2020-12-31,2021-02-19,2021-04-29,2338,1229,1109
500260,Company_28,2022-08-13,2022-09-14,2022-11-21,1696,193,1503
500261,Company_28,2022-12-09,2023-01-30,2023-03-07,2331,1272,1059
500262,Company_28,2023-01-18,2023-03-14,2023-07-05,15076,10737,4339
500263,Company_28,2022-07-14,2022-09-15,2022-10-09,17276,3908,13368
500264,Company_28,2022-10-06,2022-11-10,2022-12-24,1028,690,338
500265,Company_28,2023-08-31,2023-09-15,2024-02-19,11364,6157,5207
500266,Company_28,2020-10-03,2020-11-14,2020-12-13,14779,12560,2219
500267,Company_28,2023-05-18,2023-09-07,2024-03-20,18747,3326,15421
500268,Company_28,2022-04-21,2022-05-25,2022-06-03,7725,4220,3505
500269,Company_28,2023-04-23,2023-06-28,2023-12-29,7284,4858,2426
500270,Company_28,2021-08-06,2021-10-05,2022-01-17,1906,409,1497
500271,Company_28,2022-09-03,2022-09-27,2022-10-21,9242,3587,5655
500272,Company_28,2023-11-29,2024-02-18,2024-07-25,13014,11945,1069
500273,Company_28,2020-02-22,2020-04-28,2020-09-17,9441,7752,1689
500274,Company_29,2023-07-09,2023-10-16,2023-12-30,2412,988,1424
500275,Company_29,2020-02-01,2020-05-26,2020-07-27,14179,9343,4836
500276,Company_29,2021-04-14,2021-04-25,2021-04-28,23089,22648,441
500277,Company_29,2021-11-25,2022-02-02,2022-02-14,16001,7342,8659
500278,Company_29,2021-06-16,2021-06-26,2021-10-16,7471,4668,2803
500279,Company_29,2021-01-21,2021-02-07,2021-03-08,9308,6141,3167
500280,Company_29,2022-08-27,2022-11-06,2023-02-21,15247,4721,10526
500281,Company_29,2023-07-20,2023-08-06,2023-11-25,22051,10458,11593
500282,Company_29,2020-03-13,2020-05-29,2020-07-03,18721,9608,9113
500283,Company_30,2024-01-02,2024-02-24,2024-06-29,9962,191,9771
500284,Company_30,2023-02-05,2023-06-04,2023-07-01,22946,16817,6129
500285,Company_30,2022-04-13,2022-06-25,2022-09-06,17795,13225,4570
500286,Company_31,2023-04-22,2023-05-03,2023-10-12,23374,22572,802
500287,Company_31,2023-10-17,2024-02-12,2024-07-09,7057,1234,5823
500288,Company_31,2023-07-17,2023-09-08,2023-11-02,15070,15039,31
500289,Company_31,2021-10-31,2021-12-30,2022-02-19,7525,6044,1481
500290,Company_31,2022-07-30,2022-08-18,2023-02-04,20444,2116,18328
500291,Company_31,2020-07-04,2020-10-20,2020-11-24,10244,630,9614
500292,Company_31,2022-01-30,2022-03-08,2022-08-12,10771,4225,6546
500293,Company_31,2022-03-29,2022-06-21,2022-08-24,24054,4866,19188
500294,Company_31,2023-05-24,2023-08-26,2024-03-11,15862,8933,6929
500295,Company_31,2023-03-28,2023-04-22,2023-11-06,22856,15131,7725
500296,Company_31,2022-09-14,2022-11-06,2023-03-21,4788,722,4066
500297,Company_31,2022-07-13,2022-10-27,2023-03-05,22082,15706,6376
500298,Company_31,2021-09-23,2021-10-08,2021-11-14,17330,781,16549
500299,Company_31,2021-08-16,2021-12-12,2022-06-22,2261,1894,367
500300,Company_31,2023-05-07,2023-07-17,2024-01-16,22785,11568,11217
500301,Company_31,2023-02-11,2023-03-15,2023-09-03,12384,6843,5541
500302,Company_31,2022-09-27,2022-11-22,2023-05-11,19173,3577,15596
500303,Company_31,2022-05-16,2022-08-02,2022-09-23,19008,16989,2019
500304,Company_32,2021-09-23,2021-11-24,2022-03-29,17765,16288,1477
500305,Company_32,2022-04-13,2022-05-30,2022-06-03,11353,6972,4381
500306,Company_32,2020-12-26,2021-04-10,2021-07-05,8482,1105,7377
500307,Company_32,2023-01-22,2023-02-23,2023-06-02,17425,11644,5781
500308,Company_32,2020-10-06,2020-12-29,2021-07-09,24901,12237,12664
500309,Company_32,2020-09-07,2020-12-11,2021-02-21,4003,2228,1775
500310,Company_32,2022-12-03,2023-01-24,2023-06-19,8750,4482,4268
500311,Company_32,2022-05-21,2022-05-31,2022-11-04,21518,11264,10254
500312,Company_32,2022-05-27,2022-09-20,2022-09-22,9673,6997,2676
500313,Company_32,2022-02-17,2022-03-22,2022-05-31,9578,2767,6811
500314,Company_33,2021-03-14,2021-06-05,2021-12-13,21841,5568,16273
500315,Company_33,2023-03-13,2023-03-31,2023-04-17,24112,19724,4388
500316,Company_34,2020-05-21,2020-09-02,2021-01-07,19333,2444,16889
500317,Company_34,2022-05-22,2022-07-09,2022-09-20,13327,10746,2581
500318,Company_34,2022-06-07,2022-08-09,2023-01-19,16889,15491,1398
500319,Company_34,2021-01-02,2021-03-06,2021-08-08,1075,964,111
500320,Company_34,2021-01-20,2021-03-29,2021-10-07,22339,6841,15498
500321,Company_34,2022-03-23,2022-05-02,2022-10-10,16128,12010,4118
500322,Company_34,2020-11-19,2021-02-17,2021-06-27,3833,1757,2076
500323,Company_34,2022-12-17,2023-02-23,2023-03-03,22893,21789,1104
500324,Company_34,2022-08-07,2022-09-07,2023-02-28,17434,1440,15994
500325,Company_34,2021-06-14,2021-09-10,2021-09-20,22926,11482,11444
500326,Company_34,2023-11-30,2024-03-28,2024-05-24,23233,4103,19130
500327,Company_34,2021-10-04,2021-12-25,2022-01-23,22300,18284,4016
500328,Company_34,2022-07-02,2022-10-25,2023-01-09,7893,1974,5919
500329,Company_34,2020-10-26,2021-01-08,2021-02-21,12722,10368,2354
500330,Company_35,2020-03-10,2020-06-16,2020-07-25,20973,13212,7761
500331,Company_35,2022-04-24,2022-05-19,2022-10-30,16286,1364,14922
500332,Company_35,2023-02-01,2023-03-21,2023-08-25,5141,2840,2301
500333,Company_36,2023-01-20,2023-03-28,2023-05-07,14473,5384,9089
500334,Company_36,2022-05-03,2022-05-20,2022-06-12,17146,10378,6768
500335,Company_36,2022-07-25,2022-10-04,2023-02-27,19053,10828,8225
500336,Company_36,2020-08-06,2020-10-16,2020-12-26,5646,2307,3339
500337,Company_36,2021-08-08,2021-10-25,2022-03-05,19852,17238,2614
500338,Company_36,2021-03-31,2021-04-24,2021-09-30,5461,4888,573
500339,Company_36,2021-12-06,2022-01-09,2022-06-10,3861,2490,1371
500340,Company_36,2020-02-07,2020-06-02,2020-06-17,15699,12889,2810
500341,Company_36,2023-01-21,2023-02-03,2023-05-14,12808,8791,4017
500342,Company_36,2020-12-01,2020-12-22,2021-06-26,19003,12731,6272
500343,Company_36,2020-01-19,2020-03-18,2020-04-13,14022,13218,804
500344,Company_36,2020-02-12,2020-03-20,2020-10-02,9513,351,9162
500345,Company_36,2020-03-26,2020-04-26,2020-10-09,24877,7233,17644
500346,Company_36,2023-03-23,2023-05-19,2023-09-07,7336,5137,2199
500347,Company_36,2023-10-06,2023-12-08,2024-01-12,17339,13586,3753
500348,Company_37,2021-10-31,2021-12-05,2022-04-04,20747,2537,18210
500349,Company_37,2023-12-31,2024-02-04,2024-07-19,16776,5785,10991
500350,Company_37,2020-11-15,2021-03-06,2021-03-06,19384,18528,856
500351,Company_37,2023-02-04,2023-02-27,2023-05-09,5098,2399,2699
500352,Company_37,2022-02-10,2022-04-02,2022-10-13,20171,15477,4694
500353,Company_37,2020-02-17,2020-05-04,2020-06-28,19189,4733,14456
500354,Company_37,2022-12-11,2023-01-06,2023-02-05,24712,6513,18199
500355,Company_37,2022-09-29,2023-01-01,2023-05-06,22591,3301,19290
500356,Company_37,2023-05-11,2023-08-09,2023-09-25,15046,8576,6470
500357,Company_37,2022-04-14,2022-07-17,2022-08-06,13331,9588,3743
500358,Company_37,2023-12-06,2024-03-04,2024-03-17,24890,18315,6575
500359,Company_37,2020-09-07,2020-10-02,2020-12-10,5230,429,4801
500360,Company_37,2022-04-08,2022-06-12,2022-07-07,7815,2449,5366
500361,Company_38,2021-05-28,2021-09-17,2022-02-15,13391,9669,3722
500362,Company_38,2023-01-13,2023-03-11,2023-06-17,24489,9660,14829
500363,Company_38,2022-10-04,2023-01-10,2023-05-07,10567,10394,173
500364,Company_38,2022-03-07,2022-04-10,2022-05-09,8358,1549,6809
500365,Company_38,2022-01-16,2022-04-16,2022-08-31,7025,6320,705
500366,Company_38,2020-04-20,2020-07-17,2020-11-22,1261,74,1187
500367,Company_38,2023-02-28,2023-03-22,2023-05-22,13967,6111,7856
500368,Company_38,2022-06-29,2022-08-12,2023-02-04,14599,566,14033
500369,Company_38,2020-12-13,2020-12-29,2021-06-19,6160,3859,2301
500370,Company_38,2023-11-28,2024-02-27,2024-05-08,20242,16958,3284
500371,Company_38,2023-10-16,2023-11-24,2024-03-28,1267,385,882
500372,Company_38,2020-10-29,2021-02-12,2021-06-27,5248,2045,3203
500373,Company_38,2021-11-12,2022-01-20,2022-05-18,14858,7000,7858
500374,Company_38,2021-03-28,2021-05-19,2021-07-25,11631,4309,7322
500375,Company_38,2020-02-19,2020-06-01,2020-06-23,14678,14455,223
500376,Company_38,2022-12-04,2023-02-09,2023-05-20,5393,4991,402
500377,Company_38,2020-10-30,2021-02-09,2021-07-24,17113,10991,6122
500378,Company_38,2021-11-19,2021-12-21,2021-12-28,1309,1037,272
500379,Company_38,2020-08-21,2020-10-30,2021-04-03,2472,458,2014
500380,Company_39,2022-11-09,2022-11-26,2023-06-04,11299,287,11012
500381,Company_39,2022-02-04,2022-04-05,2022-05-28,6644,5097,1547
500382,Company_39,2020-08-23,2020-10-27,2021-02-02,18695,10154,8541
500383,Company_39,2020-12-31,2021-02-02,2021-02-08,15677,3266,12411
500384,Company_39,2021-08-04,2021-10-31,2021-12-11,13223,43,13180
500385,Company_39,2023-01-07,2023-02-23,2023-03-04,3868,3557,311
500386,Company_39,2023-02-24,2023-04-10,2023-05-31,15221,15187,34
500387,Company_39,2020-11-29,2020-12-19,2021-05-08,20743,9108,11635
500388,Company_39,2021-03-21,2021-04-16,2021-05-28,22129,5982,16147
500389,Company_39,2022-07-28,2022-09-26,2023-01-28,14472,11989,2483
500390,Company_39,2021-09-23,2021-11-03,2021-12-17,18914,12052,6862
500391,Company_39,2021-05-19,2021-06-16,2021-11-04,12866,11689,1177
500392,Company_39,2022-06-26,2022-10-09,2022-12-14,9576,4222,5354
500393,Company_39,2021-02-03,2021-05-31,2021-08-17,9150,7489,1661
500394,Company_40,2022-07-19,2022-08-03,2023-02-07,17064,12903,4161
500395,Company_40,2022-04-11,2022-07-10,2022-12-06,8554,5221,3333
500396,Company_40,2020-08-29,2020-10-23,2020-11-08,11048,343,10705
500397,Company_41,2021-10-17,2022-02-06,2022-03-01,11096,8361,2735
500398,Company_41,2020-05-12,2020-06-15,2020-09-21,17896,1264,16632
500399,Company_41,2020-03-19,2020-05-19,2020-07-17,21250,10358,10892
500400,Company_41,2021-07-26,2021-10-14,2021-12-31,15310,4947,10363
500401,Company_41,2023-08-19,2023-09-01,2024-01-27,8766,5412,3354
500402,Company_41,2022-07-01,2022-08-12,2023-02-19,802,16,786
500403,Company_41,2022-11-30,2023-03-02,2023-08-04,24764,22065,2699
500404,Company_41,2024-01-11,2024-04-26,2024-07-03,17058,16750,308
500405,Company_41,2023-11-14,2024-01-24,2024-03-21,22452,2788,19664
500406,Company_41,2021-11-04,2021-12-04,2022-04-15,17134,1732,15402
500407,Company_41,2024-01-18,2024-01-29,2024-05-07,8462,6282,2180
500408,Company_42,2023-01-21,2023-03-25,2023-08-26,3344,1154,2190
500409,Company_42,2022-03-23,2022-05-21,2022-12-01,16081,361,15720
500410,Company_42,2021-01-01,2021-04-27,2021-10-25,6567,6563,4
500411,Company_42,2020-12-25,2021-02-15,2021-07-01,2661,729,1932
500412,Company_42,2023-11-13,2023-11-23,2024-06-08,22860,227,22633
500413,Company_42,2023-03-02,2023-05-23,2023-11-19,15210,15039,171
500414,Company_42,2022-09-05,2022-11-27,2023-04-24,13956,11245,2711
500415,Company_42,2023-08-21,2023-11-10,2023-12-23,15546,3549,11997
500416,Company_42,2021-08-13,2021-11-10,2022-04-05,12505,6838,5667
500417,Company_42,2022-12-22,2023-03-20,2023-09-16,5065,11,5054
500418,Company_42,2022-05-21,2022-08-25,2023-01-13,24770,8343,16427
500419,Company_42,2022-04-01,2022-06-10,2022-12-02,23991,2504,21487
500420,Company_42,2023-04-12,2023-05-27,2023-09-23,21220,20149,1071
500421,Company_42,2023-03-04,2023-05-06,2023-05-07,7020,5331,1689
500422,Company_42,2021-07-30,2021-10-17,2022-02-01,13216,9017,4199
500423,Company_42,2020-01-22,2020-04-22,2020-08-26,19936,18966,970
500424,Company_43,2021-04-02,2021-07-15,2021-07-27,1435,43,1392
500425,Company_43,2022-08-26,2022-11-02,2023-03-13,23473,14408,9065
500426,Company_43,2023-07-18,2023-08-19,2023-12-15,20306,15318,4988
500427,Company_43,2023-10-04,2023-10-31,2023-11-22,19348,8946,10402
500428,Company_43,2023-09-09,2023-10-21,2024-03-13,9549,9153,396
500429,Company_44,2021-01-30,2021-03-01,2021-04-24,2077,520,1557
500430,Company_44,2022-10-05,2022-10-19,2023-02-26,7987,7049,938
500431,Company_44,2022-07-03,2022-07-26,2022-08-22,22803,17469,5334
500432,Company_44,2020-03-10,2020-06-21,2020-09-05,15715,7328,8387
500433,Company_44,2022-01-11,2022-04-04,2022-05-27,2134,1907,227
500434,Company_44,2021-02-13,2021-02-28,2021-07-20,7092,3547,3545
500435,Company_44,2022-07-30,2022-10-12,2023-02-09,13256,6170,7086
500436,Company_44,2022-09-19,2022-10-05,2023-04-21,4166,2232,1934
500437,Company_44,2021-11-27,2022-01-03,2022-03-21,14297,9511,4786
500438,Company_44,2020-10-17,2021-01-17,2021-04-08,12836,6208,6628
500439,Company_44,2022-06-01,2022-06-29,2022-08-16,16551,12967,3584
500440,Company_44,2020-01-24,2020-03-10,2020-06-11,13131,10501,2630
500441,Company_44,2020-06-15,2020-08-29,2021-03-03,6943,574,6369
500442,Company_44,2021-09-20,2021-10-19,2022-04-21,9310,560,8750
500443,Company_44,2020-06-04,2020-06-23,2020-09-30,11378,8726,2652
500444,Company_45,2020-11-17,2021-01-21,2021-01-27,894,416,478
500445,Company_45,2020-06-07,2020-07-05,2020-10-17,3741,2064,1677
500446,Company_45,2020-06-14,2020-09-03,2020-11-03,7898,2765,5133
500447,Company_45,2023-11-07,2024-01-22,2024-07-25,23718,6594,17124
500448,Company_46,2021-09-11,2021-10-26,2021-11-20,17533,12196,5337
500449,Company_46,2020-12-11,2021-03-25,2021-07-23,15922,6347,9575
500450,Company_46,2021-11-09,2022-01-23,2022-02-23,17421,8818,8603
500451,Company_46,2022-11-30,2023-02-23,2023-06-13,8943,5510,3433
500452,Company_46,2022-12-27,2023-02-15,2023-07-24,17164,1008,16156
500453,Company_46,2023-04-28,2023-06-17,2023-09-23,24839,14435,10404
500454,Company_46,2021-04-29,2021-06-28,2021-11-09,6446,6311,135
500455,Company_46,2020-07-19,2020-11-02,2021-04-01,12224,10661,1563
500456,Company_46,2022-09-20,2022-11-11,2023-02-21,8565,5729,2836
500457,Company_46,2022-12-25,2023-01-09,2023-03-13,21186,11740,9446
500458,Company_46,2023-07-24,2023-10-10,2024-04-24,20912,13413,7499
500459,Company_46,2021-02-09,2021-04-11,2021-10-02,5584,1598,3986
500460,Company_46,2021-01-06,2021-04-18,2021-10-10,22902,3362,19540
500461,Company_46,2020-05-18,2020-09-01,2020-12-26,12296,7465,4831
500462,Company_46,2021-04-21,2021-06-30,2021-09-25,12640,2894,9746
500463,Company_46,2022-09-17,2022-09-28,2022-10-25,20661,2544,18117
500464,Company_46,2021-05-24,2021-09-07,2022-03-17,9159,5466,3693
500465,Company_46,2021-12-30,2022-01-18,2022-07-22,23987,14559,9428
500466,Company_46,2022-09-29,2023-01-02,2023-06-09,3731,622,3109
500467,Company_47,2021-12-06,2021-12-24,2022-02-26,17808,14276,3532
500468,Company_47,2023-12-23,2024-03-05,2024-06-25,20608,10209,10399
500469,Company_47,2022-01-21,2022-05-16,2022-08-04,23729,8375,15354
500470,Company_47,2021-04-07,2021-04-19,2021-05-31,4512,4460,52
500471,Company_47,2022-10-22,2023-01-01,2023-06-04,4627,4614,13
500472,Company_47,2021-12-26,2022-04-13,2022-10-23,6292,5410,882
500473,Company_47,2023-03-10,2023-05-04,2023-05-11,21844,17547,4297
500474,Company_47,2022-09-26,2022-12-04,2023-04-05,22864,19313,3551
500475,Company_47,2020-03-19,2020-04-25,2020-08-05,17968,189,17779
500476,Company_47,2020-07-02,2020-08-07,2020-09-25,6074,237,5837
500477,Company_47,2022-09-02,2022-10-28,2023-05-15,9366,4892,4474
500478,Company_48,2022-07-02,2022-10-08,2023-02-11,14287,10164,4123
500479,Company_48,2020-06-29,2020-08-27,2020-09-24,16842,13816,3026
500480,Company_48,2023-09-28,2024-01-15,2024-04-17,22992,9996,12996
500481,Company_48,2020-06-23,2020-07-11,2020-08-14,23754,8599,15155
500482,Company_48,2020-02-03,2020-03-20,2020-08-26,21202,9092,12110
500483,Company_48,2022-12-14,2023-02-23,2023-09-02,24967,16892,8075
500484,Company_48,2023-06-06,2023-07-21,2023-08-15,13052,8085,4967
500485,Company_48,2021-08-29,2021-10-06,2021-10-17,12375,2747,9628
500486,Company_48,2023-10-04,2023-11-28,2024-04-17,15807,5627,10180
500487,Company_48,2023-12-03,2024-02-10,2024-07-25,21621,12886,8735
500488,Company_48,2021-07-05,2021-08-08,2021-12-11,21567,7108,14459
500489,Company_48,2020-11-29,2020-12-13,2021-06-22,3652,1435,2217
500490,Company_48,2022-09-09,2022-10-03,2023-03-06,8734,5765,2969
500491,Company_48,2023-05-11,2023-08-30,2023-12-21,4168,1278,2890
500492,Company_48,2021-07-06,2021-10-22,2021-11-11,17553,1500,16053
500493,Company_48,2020-02-29,2020-03-12,2020-07-09,1466,780,686
500494,Company_49,2023-11-05,2024-02-15,2024-03-14,23284,5230,18054
500495,Company_49,2023-09-06,2023-10-14,2024-01-24,17991,16727,1264
500496,Company_49,2022-01-22,2022-03-26,2022-10-10,4417,1716,2701
500497,Company_49,2021-08-11,2021-09-04,2021-09-09,3921,3511,410
500498,Company_49,2021-10-24,2021-11-21,2021-12-22,13525,6399,7126
500499,Company_49,2020-08-24,2020-11-08,2021-02-28,2331,377,1954
500500,Company_49,2023-06-22,2023-07-16,2023-12-11,8361,985,7376
500501,Company_49,2022-12-10,2023-04-05,2023-04-28,20216,282,19934
500502,Company_49,2023-06-04,2023-09-24,2024-01-14,1666,1025,641
500503,Company_49,2021-09-11,2021-10-19,2022-04-05,4658,2897,1761
500504,Company_49,2020-10-24,2021-02-16,2021-03-10,24113,23275,838
500505,Company_49,2022-01-09,2022-01-28,2022-03-15,23159,7385,15774
500506,Company_49,2021-10-09,2021-10-23,2022-01-02,9998,4585,5413
500507,Company_49,2022-10-16,2022-12-16,2023-04-26,20616,10510,10106
500508,Company_49,2021-03-14,2021-06-26,2022-01-01,16308,7687,8621
500509,Company_49,2023-01-13,2023-03-30,2023-08-05,6139,2365,3774
500510,Company_49,2023-05-06,2023-05-17,2023-10-23,7763,7103,660
500511,Company_49,2023-07-13,2023-10-03,2023-12-23,14074,12459,1615
500512,Company_50,2021-05-18,2021-06-10,2021-10-04,11341,3107,8234
500513,Company_50,2022-10-06,2022-11-16,2023-03-11,23295,4731,18564
500514,Company_50,2021-05-25,2021-07-24,2021-07-30,21760,3616,18144
500515,Company_50,2021-11-08,2021-12-27,2022-06-18,12069,10613,1456
500516,Company_50,2020-10-26,2021-01-07,2021-03-12,17620,13255,4365
500517,Company_50,2022-09-24,2023-01-14,2023-05-11,17858,11554,6304
500518,Company_50,2020-12-09,2021-03-05,2021-08-05,2618,382,2236
500519,Company_50,2022-12-16,2023-01-28,2023-03-16,15640,10224,5416
500520,Company_50,2022-05-27,2022-06-21,2022-12-07,5264,4987,277
500521,Company_50,2022-04-09,2022-05-15,2022-05-18,8461,1166,7295
500522,Company_50,2023-01-30,2023-03-06,2023-08-26,12447,6943,5504
500523,Company_50,2022-03-30,2022-05-25,2022-11-11,6904,1011,5893
500524,Company_50,2021-07-09,2021-08-06,2021-12-11,17690,16,17674
500525,Company_50,2020-08-10,2020-09-27,2020-10-15,7853,274,7579
500526,Company_50,2020-10-22,2020-12-07,2021-04-13,12969,2773,10196
500527,Company_50,2022-02-06,2022-04-12,2022-08-21,14482,5653,8829
500528,Company_50,2020-06-30,2020-07-26,2020-09-13,20982,18112,2870
500529,Company_51,2021-02-03,2021-04-13,2021-08-01,2801,854,1947
500530,Company_51,2020-02-23,2020-03-26,2020-04-19,18617,15813,2804
500531,Company_51,2023-05-14,2023-07-28,2023-11-30,6444,3860,2584
500532,Company_51,2020-10-19,2020-12-20,2021-03-04,23472,23390,82
500533,Company_51,2023-12-01,2024-02-28,2024-08-12,2544,916,1628
500534,Company_51,2023-08-07,2023-10-02,2024-01-09,13039,2517,10522
500535,Company_51,2020-08-28,2020-11-30,2021-03-31,18623,15034,3589
500536,Company_51,2023-10-01,2024-01-14,2024-01-15,2320,637,1683
500537,Company_51,2022-11-21,2023-03-16,2023-04-27,5256,3273,1983
500538,Company_52,2023-02-17,2023-03-08,2023-09-06,8886,1289,7597
500539,Company_52,2022-02-23,2022-04-29,2022-05-06,22830,6550,16280
500540,Company_52,2021-08-15,2021-09-12,2022-03-19,4581,102,4479
500541,Company_52,2021-01-30,2021-04-26,2021-05-18,959,452,507
500542,Company_52,2023-08-25,2023-11-23,2023-11-30,6029,1933,4096
500543,Company_52,2020-04-17,2020-06-18,2020-07-11,18831,5693,13138
500544,Company_52,2023-07-01,2023-08-15,2023-09-03,8762,5966,2796
500545,Company_52,2021-12-20,2022-01-07,2022-02-05,1358,17,1341
500546,Company_53,2021-09-03,2021-12-03,2022-01-07,6991,3622,3369
500547,Company_53,2020-06-12,2020-09-13,2021-02-13,10161,5500,4661
500548,Company_53,2021-12-18,2022-03-03,2022-05-11,5362,974,4388
500549,Company_53,2022-08-03,2022-09-01,2022-09-16,21870,4141,17729
500550,Company_53,2023-01-01,2023-03-25,2023-06-11,12483,3783,8700
500551,Company_53,2021-07-03,2021-08-21,2021-09-04,11820,5674,6146
500552,Company_53,2023-02-01,2023-04-14,2023-08-16,12373,9659,2714
500553,Company_54,2023-08-23,2023-10-15,2024-04-25,9645,4083,5562
500554,Company_54,2022-05-09,2022-07-02,2022-07-25,18657,15561,3096
500555,Company_54,2020-07-27,2020-09-14,2021-03-09,18430,725,17705
500556,Company_55,2020-07-01,2020-10-13,2021-03-23,14687,11649,3038
500557,Company_55,2022-11-29,2023-03-27,2023-07-08,2926,2769,157
500558,Company_55,2022-10-16,2023-01-05,2023-04-17,1266,269,997
500559,Company_55,2020-11-25,2020-12-30,2021-01-20,23847,11800,12047
500560,Company_55,2023-01-12,2023-05-09,2023-06-26,7697,5735,1962
500561,Company_55,2020-05-08,2020-08-05,2021-01-05,16162,11481,4681
500562,Company_55,2021-05-01,2021-06-02,2021-06-11,19432,5492,13940
500563,Company_55,2022-01-21,2022-03-11,2022-07-22,9603,3634,5969
500564,Company_55,2020-02-01,2020-02-24,2020-05-11,11928,8742,3186
500565,Company_55,2023-12-13,2024-02-23,2024-03-02,16038,13829,2209
500566,Company_55,2022-06-25,2022-10-12,2023-04-27,7713,788,6925
500567,Company_55,2022-02-22,2022-04-19,2022-05-25,10852,10119,733
500568,Company_55,2020-03-21,2020-04-29,2020-07-26,21868,14529,7339
500569,Company_55,2022-10-24,2022-11-12,2023-01-06,18886,4001,14885
500570,Company_55,2021-05-23,2021-07-17,2021-11-23,12944,2962,9982
500571,Company_55,2022-03-28,2022-06-30,2022-10-09,10238,4574,5664
500572,Company_55,2023-12-19,2024-01-17,2024-02-20,4165,1708,2457
500573,Company_55,2022-03-29,2022-06-06,2022-07-28,7627,2964,4663
500574,Company_56,2021-07-24,2021-09-20,2022-01-06,11135,282,10853
500575,Company_56,2021-01-26,2021-03-14,2021-08-29,24316,4448,19868
500576,Company_56,2022-02-23,2022-06-07,2022-08-05,8081,456,7625
500577,Company_56,2020-03-28,2020-06-11,2020-09-14,14976,5042,9934
500578,Company_56,2020-10-01,2020-11-30,2021-01-22,10311,849,9462
500579,Company_56,2023-01-21,2023-02-27,2023-06-04,23686,22621,1065
500580,Company_56,2020-03-07,2020-05-31,2020-06-03,13871,10157,3714
500581,Company_56,2023-06-29,2023-08-04,2024-02-02,21938,297,21641
500582,Company_56,2023-11-26,2024-02-09,2024-04-20,3637,3122,515
500583,Company_56,2022-01-11,2022-02-08,2022-03-05,9521,1189,8332
500584,Company_56,2021-12-29,2022-04-22,2022-10-01,22269,7772,14497
500585,Company_56,2021-09-11,2021-10-29,2021-11-04,9497,2090,7407
500586,Company_56,2022-08-09,2022-08-24,2022-11-30,7293,1918,5375
500587,Company_56,2020-06-14,2020-09-23,2020-11-09,2414,428,1986
500588,Company_56,2022-02-11,2022-03-06,2022-05-15,17776,2965,14811
500589,Company_57,2022-06-30,2022-08-11,2022-09-05,9831,8155,1676
500590,Company_57,2022-10-30,2022-12-03,2023-03-18,7512,500,7012
500591,Company_57,2023-10-26,2023-12-24,2024-04-29,14841,1591,13250
500592,Company_57,2022-03-26,2022-06-10,2022-11-06,14916,10708,4208
500593,Company_57,2021-03-17,2021-06-01,2021-12-01,18487,1344,17143
500594,Company_57,2023-03-21,2023-04-18,2023-10-22,13299,5112,8187
500595,Company_57,2023-06-30,2023-09-26,2023-12-13,17585,471,17114
500596,Company_57,2023-01-14,2023-03-22,2023-08-15,19237,12846,6391
500597,Company_57,2022-08-30,2022-12-06,2023-02-14,2900,34,2866
500598,Company_57,2021-02-18,2021-04-19,2021-09-20,20427,15758,4669
500599,Company_57,2022-08-02,2022-08-30,2023-01-01,2884,1350,1534
500600,Company_57,2020-11-30,2020-12-12,2021-02-28,22409,12418,9991
500601,Company_57,2021-04-30,2021-08-13,2022-02-23,7346,2100,5246
500602,Company_57,2021-06-20,2021-07-03,2021-08-31,4459,720,3739
500603,Company_57,2022-09-15,2022-12-12,2023-03-05,2074,1304,770
500604,Company_57,2024-01-30,2024-03-12,2024-04-23,19165,4543,14622
500605,Company_57,2022-06-30,2022-10-26,2023-02-09,9218,2371,6847
500606,Company_58,2020-10-29,2021-02-25,2021-05-24,12996,12719,277
500607,Company_58,2021-07-29,2021-08-14,2022-02-24,5227,3902,1325
500608,Company_58,2023-10-28,2023-12-23,2024-05-31,24229,7186,17043
500609,Company_58,2023-11-09,2023-12-10,2024-04-16,18302,17328,974
500610,Company_58,2022-07-11,2022-08-01,2022-08-21,19526,591,18935
500611,Company_58,2023-05-10,2023-08-23,2024-03-03,22238,14483,7755
500612,Company_58,2020-02-07,2020-03-17,2020-07-14,14978,5539,9439
500613,Company_58,2020-05-09,2020-06-26,2020-08-14,20886,10258,10628
500614,Company_58,2020-08-17,2020-09-19,2021-03-05,7820,7398,422
500615,Company_58,2021-04-13,2021-08-04,2021-12-21,4747,2933,1814
500616,Company_59,2023-12-05,2024-03-05,2024-08-09,5433,1760,3673
500617,Company_59,2024-01-18,2024-05-07,2024-06-30,19957,1696,18261
500618,Company_59,2021-01-18,2021-05-14,2021-06-30,13199,11166,2033
500619,Company_59,2023-01-11,2023-03-09,2023-09-22,3596,2027,1569
500620,Company_59,2022-09-08,2022-11-03,2023-04-12,17979,10023,7956
500621,Company_59,2023-02-07,2023-05-02,2023-07-31,21494,17461,4033
500622,Company_59,2020-04-01,2020-07-13,2020-09-11,3381,2175,1206
500623,Company_59,2022-06-28,2022-10-20,2023-04-01,24360,3768,20592
500624,Company_59,2023-07-01,2023-09-07,2023-09-23,2965,1094,1871
500625,Company_59,2022-09-22,2022-10-03,2023-03-15,16469,7054,9415
500626,Company_59,2024-01-23,2024-05-03,2024-07-30,5838,5286,552
500627,Company_59,2022-06-09,2022-07-16,2022-08-12,21774,1443,20331
500628,Company_59,2023-11-19,2024-01-05,2024-07-02,10545,8548,1997
500629,Company_59,2020-08-11,2020-10-04,2020-11-13,22274,3725,18549
500630,Company_59,2023-04-19,2023-05-05,2023-05-09,4522,2574,1948
500631,Company_60,2022-10-15,2023-02-06,2023-06-27,4737,3588,1149
500632,Company_60,2021-02-24,2021-06-13,2021-09-25,23377,3805,19572
500633,Company_60,2020-10-28,2020-12-14,2020-12-22,10896,3922,6974
500634,Company_60,2023-04-24,2023-05-20,2023-07-10,1509,117,1392
500635,Company_60,2020-12-31,2021-01-10,2021-07-19,7421,35,7386
500636,Company_60,2020-12-22,2021-02-23,2021-05-13,10665,10444,221
500637,Company_60,2022-07-10,2022-07-23,2022-10-07,12465,10696,1769
500638,Company_60,2021-09-29,2022-01-04,2022-01-22,8608,8475,133
500639,Company_60,2022-07-15,2022-08-18,2022-08-20,24203,3340,20863
500640,Company_61,2021-10-23,2022-01-18,2022-02-16,6762,3088,3674
500641,Company_61,2021-07-15,2021-08-15,2022-02-18,21342,9633,11709
500642,Company_61,2023-12-14,2024-03-16,2024-09-19,6347,927,5420
500643,Company_61,2021-07-05,2021-10-04,2021-10-10,18320,11311,7009
500644,Company_61,2021-11-04,2022-01-30,2022-04-12,14181,10351,3830
500645,Company_61,2023-04-08,2023-06-10,2023-09-15,10656,5488,5168
500646,Company_61,2021-02-07,2021-04-18,2021-05-27,24078,19669,4409
500647,Company_62,2020-09-17,2020-12-18,2021-05-08,15190,315,14875
500648,Company_62,2023-01-16,2023-04-02,2023-07-01,18194,15936,2258
500649,Company_62,2020-03-31,2020-07-15,2020-10-29,1042,822,220
500650,Company_62,2020-04-18,2020-07-05,2020-11-10,20507,15639,4868
500651,Company_62,2021-11-07,2021-12-13,2022-03-02,13174,8035,5139
500652,Company_62,2021-12-04,2021-12-30,2022-01-09,3538,2375,1163
500653,Company_62,2022-08-03,2022-09-07,2023-01-14,1539,1150,389
500654,Company_62,2023-07-05,2023-08-01,2024-01-31,15095,7005,8090
500655,Company_62,2021-10-28,2022-02-23,2022-05-24,5676,1581,4095
500656,Company_62,2020-06-08,2020-07-03,2020-08-19,3387,1168,2219
500657,Company_62,2023-12-18,2024-03-09,2024-05-14,4510,752,3758
500658,Company_62,2023-04-12,2023-06-25,2023-12-26,22828,558,22270
500659,Company_62,2020-12-27,2021-03-09,2021-06-27,9710,8377,1333
500660,Company_62,2022-07-07,2022-09-23,2022-12-02,18606,5143,13463
500661,Company_62,2022-10-19,2023-01-06,2023-04-25,11237,2699,8538
500662,Company_62,2022-02-22,2022-05-28,2022-10-31,1110,1080,30
500663,Company_63,2023-09-16,2023-10-12,2024-03-29,7332,2854,4478
500664,Company_63,2021-07-08,2021-08-06,2022-02-05,13197,2697,10500
500665,Company_63,2020-04-04,2020-05-20,2020-07-21,9168,2755,6413
500666,Company_63,2022-12-18,2023-01-07,2023-06-06,17738,13170,4568
500667,Company_63,2023-04-12,2023-05-25,2023-07-25,17509,8225,9284
500668,Company_63,2022-05-08,2022-07-29,2022-08-21,23264,529,22735
500669,Company_63,2022-07-20,2022-09-20,2022-11-26,8209,3590,4619
500670,Company_63,2020-03-21,2020-04-13,2020-07-14,10799,10722,77
500671,Company_64,2021-05-15,2021-07-25,2021-11-01,4553,2775,1778
500672,Company_64,2021-01-21,2021-04-05,2021-09-22,8158,3562,4596
500673,Company_64,2021-05-03,2021-07-05,2021-07-12,10382,9251,1131
500674,Company_64,2021-08-19,2021-11-17,2022-04-17,1541,1165,376
500675,Company_64,2021-06-26,2021-07-07,2021-10-19,20168,3263,16905
500676,Company_64,2021-12-20,2022-01-22,2022-04-11,4694,261,4433
500677,Company_64,2022-05-26,2022-08-13,2022-12-06,3236,1947,1289
500678,Company_64,2020-05-01,2020-07-17,2020-08-09,12495,1200,11295
500679,Company_64,2020-10-04,2021-01-05,2021-07-17,21886,19917,1969
500680,Company_64,2021-11-06,2022-01-25,2022-07-07,6357,6332,25
500681,Company_64,2021-11-03,2021-12-07,2022-06-21,1254,1106,148
500682,Company_64,2022-09-11,2022-10-03,2023-01-02,9497,1547,7950
500683,Company_64,2021-07-22,2021-11-14,2022-02-21,22348,9396,12952
500684,Company_64,2022-02-14,2022-04-29,2022-08-14,13449,11115,2334
500685,Company_64,2020-08-21,2020-11-04,2021-03-15,5129,3302,1827
500686,Company_64,2023-05-17,2023-06-30,2023-08-07,13883,2749,11134
500687,Company_65,2022-03-23,2022-06-09,2022-08-31,2515,1578,937
500688,Company_65,2022-03-21,2022-05-24,2022-07-06,7120,1597,5523
500689,Company_65,2020-08-31,2020-10-06,2021-03-09,15567,11998,3569
500690,Company_65,2021-08-08,2021-09-08,2022-03-19,5030,603,4427
500691,Company_65,2022-06-18,2022-07-19,2022-12-26,24436,11639,12797
500692,Company_65,2021-01-02,2021-02-03,2021-02-05,22752,11214,11538
500693,Company_65,2020-08-17,2020-09-07,2020-11-09,5176,4838,338
500694,Company_65,2021-09-05,2021-10-14,2022-03-28,11729,1050,10679
500695,Company_65,2023-02-26,2023-05-30,2023-09-09,6802,6411,391
500696,Company_65,2022-12-18,2023-01-26,2023-05-19,17875,2317,15558
500697,Company_65,2021-11-28,2022-01-19,2022-02-12,1210,990,220
500698,Company_65,2023-08-18,2023-09-26,2023-11-29,12404,8781,3623
500699,Company_65,2021-08-04,2021-10-28,2022-01-18,15555,5593,9962
500700,Company_65,2021-04-06,2021-06-18,2021-07-05,21379,19045,2334
500701,Company_65,2021-03-17,2021-06-26,2022-01-10,16425,7296,9129
500702,Company_65,2020-09-28,2020-12-24,2021-06-04,20840,19937,903
500703,Company_65,2023-08-21,2023-09-18,2024-03-25,15204,4482,10722
500704,Company_66,2023-04-14,2023-04-24,2023-05-08,7137,6426,711
500705,Company_66,2022-09-07,2022-09-19,2022-10-18,11507,6680,4827
500706,Company_66,2023-03-09,2023-07-02,2023-12-15,11529,4236,7293
500707,Company_67,2020-01-19,2020-04-08,2020-10-20,5758,3841,1917
500708,Company_67,2021-02-07,2021-03-03,2021-04-29,12163,1546,10617
500709,Company_67,2023-11-09,2024-01-13,2024-01-19,2952,2517,435
500710,Company_67,2022-11-25,2022-12-23,2023-01-27,20044,8488,11556
500711,Company_67,2021-06-11,2021-07-31,2022-01-25,9914,7182,2732
500712,Company_67,2020-04-29,2020-06-24,2020-11-13,21804,12355,9449
500713,Company_67,2024-02-03,2024-03-19,2024-07-13,17952,97,17855
500714,Company_67,2023-06-19,2023-07-24,2024-01-09,15189,403,14786
500715,Company_67,2022-05-07,2022-08-31,2022-09-12,11458,2553,8905
500716,Company_67,2022-04-04,2022-06-27,2022-09-24,4252,1265,2987
500717,Company_67,2020-03-28,2020-07-14,2020-07-21,24867,11972,12895
500718,Company_67,2022-10-21,2022-12-13,2023-06-25,8871,1444,7427
500719,Company_67,2023-10-30,2024-02-07,2024-04-16,1047,512,535
500720,Company_67,2024-01-28,2024-04-06,2024-05-07,6497,242,6255
500721,Company_67,2023-05-11,2023-08-06,2023-08-30,1170,1010,160
500722,Company_68,2020-02-18,2020-03-17,2020-04-20,24453,14068,10385
500723,Company_68,2023-07-29,2023-09-13,2024-02-11,14937,10521,4416
500724,Company_68,2023-06-19,2023-07-09,2024-01-15,23604,2556,21048
500725,Company_68,2022-04-28,2022-07-24,2022-12-31,24579,11049,13530
500726,Company_68,2023-01-10,2023-03-17,2023-09-04,2034,2008,26
500727,Company_68,2021-10-20,2022-01-16,2022-06-18,1408,1069,339
500728,Company_68,2021-11-27,2022-01-15,2022-07-04,16542,5908,10634
500729,Company_68,2020-02-19,2020-05-27,2020-10-11,18672,4773,13899
500730,Company_68,2021-01-04,2021-02-23,2021-05-18,20114,14825,5289
500731,Company_68,2022-06-20,2022-07-21,2022-11-29,15590,14678,912
500732,Company_68,2021-08-17,2021-08-30,2022-01-17,2444,1663,781
500733,Company_68,2021-09-21,2021-12-11,2022-05-11,8215,4544,3671
500734,Company_68,2021-11-24,2022-03-06,2022-03-28,2470,896,1574
500735,Company_68,2023-05-16,2023-07-01,2024-01-11,7045,933,6112
500736,Company_68,2021-08-20,2021-09-22,2021-12-13,3399,2309,1090
500737,Company_68,2022-01-21,2022-05-03,2022-10-04,16498,4386,12112
500738,Company_69,2021-06-05,2021-08-28,2021-12-18,23956,4920,19036
500739,Company_69,2022-10-25,2022-11-15,2023-01-27,24593,19964,4629
500740,Company_69,2023-03-30,2023-07-05,2023-09-30,16682,11088,5594
500741,Company_69,2022-02-11,2022-04-17,2022-09-17,17798,3657,14141
500742,Company_69,2022-02-07,2022-03-22,2022-04-21,11599,9817,1782
500743,Company_69,2021-10-03,2021-12-08,2022-06-19,22138,4028,18110
500744,Company_69,2023-07-16,2023-09-01,2023-12-17,14788,3888,10900
500745,Company_69,2021-10-27,2022-01-10,2022-05-20,20540,13358,7182
500746,Company_69,2020-07-27,2020-10-20,2021-01-12,2675,1127,1548
500747,Company_70,2022-12-30,2023-02-14,2023-05-19,20618,15797,4821
500748,Company_70,2020-09-22,2020-10-05,2021-03-25,20263,7500,12763
500749,Company_71,2023-11-10,2023-11-26,2024-03-16,7006,2632,4374
500750,Company_71,2020-07-01,2020-10-01,2021-04-18,6142,4024,2118
500751,Company_71,2021-01-13,2021-04-29,2021-05-12,9249,4302,4947
500752,Company_71,2021-10-04,2022-01-17,2022-04-16,15921,8120,7801
500753,Company_71,2020-08-14,2020-09-12,2021-01-08,13218,2014,11204
500754,Company_71,2020-06-21,2020-07-03,2020-08-25,9808,9108,700
500755,Company_71,2021-04-16,2021-06-09,2021-08-28,19791,16343,3448
500756,Company_71,2020-03-07,2020-05-05,2020-06-18,22831,6897,15934
500757,Company_71,2020-03-06,2020-03-18,2020-06-10,14744,3928,10816
500758,Company_71,2020-05-10,2020-07-01,2020-11-13,14675,6296,8379
500759,Company_71,2020-02-03,2020-05-19,2020-07-26,9471,939,8532
500760,Company_71,2022-05-27,2022-07-22,2022-09-19,13345,6919,6426
500761,Company_71,2020-07-01,2020-10-22,2020-11-20,2466,1107,1359
500762,Company_71,2021-07-22,2021-11-08,2021-12-21,3804,2534,1270
500763,Company_71,2021-01-29,2021-04-01,2021-09-22,7634,5589,2045
500764,Company_71,2021-12-18,2022-01-17,2022-07-13,17542,14251,3291
500765,Company_71,2023-02-11,2023-06-09,2023-08-06,13844,8558,5286
500766,Company_72,2021-10-06,2022-01-27,2022-03-12,24578,20171,4407
500767,Company_72,2024-01-28,2024-03-01,2024-07-23,1559,1261,298
500768,Company_73,2020-12-02,2021-02-05,2021-06-14,6755,720,6035
500769,Company_73,2020-02-24,2020-03-30,2020-07-02,14895,10785,4110
500770,Company_73,2021-04-11,2021-06-03,2021-10-10,13405,11685,1720
500771,Company_73,2022-09-16,2022-10-21,2022-12-24,2946,1530,1416
500772,Company_73,2020-07-22,2020-10-28,2021-03-17,22283,17248,5035
500773,Company_73,2020-07-17,2020-08-14,2021-01-20,15493,14111,1382
500774,Company_73,2023-06-17,2023-10-11,2024-04-26,940,586,354
500775,Company_74,2023-12-27,2024-02-23,2024-06-24,10951,4182,6769
500776,Company_74,2020-12-20,2021-03-18,2021-07-06,4284,3546,738
500777,Company_74,2023-01-19,2023-04-11,2023-05-20,3046,420,2626
500778,Company_74,2022-07-16,2022-08-16,2022-10-21,9778,39,9739
500779,Company_75,2021-07-05,2021-11-01,2022-05-07,15351,4057,11294
500780,Company_75,2022-09-20,2022-12-31,2023-03-03,10492,4960,5532
500781,Company_75,2021-01-12,2021-02-20,2021-04-08,10822,2672,8150
500782,Company_75,2022-09-02,2022-10-12,2022-11-01,24306,17025,7281
500783,Company_76,2022-10-18,2022-11-07,2023-02-23,12785,8058,4727
500784,Company_76,2022-02-10,2022-02-21,2022-02-22,22214,1452,20762
500785,Company_76,2020-12-24,2021-03-27,2021-04-12,5882,2178,3704
500786,Company_76,2020-02-19,2020-06-02,2020-09-03,23312,22291,1021
500787,Company_77,2022-07-14,2022-09-18,2023-03-13,15148,12897,2251
500788,Company_77,2022-07-16,2022-10-17,2023-01-15,23842,9825,14017
500789,Company_77,2021-04-19,2021-06-22,2021-08-25,14291,13487,804
500790,Company_78,2021-04-16,2021-07-25,2021-09-10,24882,1159,23723
500791,Company_78,2020-02-25,2020-04-04,2020-08-15,13038,5610,7428
500792,Company_78,2021-09-20,2021-11-13,2022-03-07,5010,950,4060
500793,Company_78,2023-02-15,2023-02-26,2023-06-02,4970,3223,1747
500794,Company_78,2022-11-15,2023-01-19,2023-02-07,7151,2877,4274
500795,Company_78,2023-08-04,2023-10-17,2024-03-06,3878,3008,870
500796,Company_79,2022-12-29,2023-02-22,2023-03-11,23924,4170,19754
500797,Company_79,2022-04-25,2022-06-27,2022-11-02,12725,990,11735
500798,Company_79,2021-01-21,2021-02-04,2021-02-08,7698,7534,164
500799,Company_79,2020-05-15,2020-06-11,2020-06-29,5646,3962,1684
500800,Company_79,2022-12-06,2023-04-02,2023-07-09,22478,7751,14727
500801,Company_79,2021-11-22,2021-12-31,2022-05-12,18272,11375,6897
500802,Company_79,2021-11-25,2022-02-01,2022-03-10,9174,2219,6955
500803,Company_79,2023-03-18,2023-07-13,2023-08-25,7599,1640,5959
500804,Company_79,2022-12-08,2022-12-20,2023-06-23,13848,2454,11394
500805,Company_79,2020-04-16,2020-05-27,2020-10-12,7072,4887,2185
500806,Company_79,2023-09-11,2023-10-19,2024-03-30,18618,17019,1599
500807,Company_79,2023-02-15,2023-03-09,2023-08-04,23376,21361,2015
500808,Company_79,2022-03-16,2022-06-22,2022-09-08,4846,2877,1969
500809,Company_79,2021-12-25,2022-01-28,2022-07-19,4931,2215,2716
500810,Company_79,2023-07-23,2023-08-19,2023-12-15,5914,3913,2001
500811,Company_79,2020-03-08,2020-05-22,2020-07-26,5870,5663,207
500812,Company_79,2022-11-28,2023-01-22,2023-07-07,3436,1982,1454
500813,Company_79,2023-10-30,2023-12-31,2024-05-12,17858,9641,8217
500814,Company_79,2020-01-05,2020-04-23,2020-10-07,6653,1992,4661
500815,Company_80,2023-07-27,2023-08-11,2023-12-09,18751,6421,12330
500816,Company_80,2020-03-17,2020-06-20,2020-07-25,3620,1703,1917
500817,Company_80,2022-01-12,2022-02-06,2022-06-19,5521,1653,3868
500818,Company_80,2023-02-24,2023-04-15,2023-08-24,16696,13565,3131
500819,Company_80,2024-01-13,2024-02-04,2024-06-29,12096,8926,3170
500820,Company_80,2021-11-06,2022-03-01,2022-09-13,10200,2936,7264
500821,Company_80,2023-08-21,2023-11-04,2024-02-16,8241,7605,636
500822,Company_80,2023-05-13,2023-08-16,2023-09-16,15194,5328,9866
500823,Company_80,2021-04-26,2021-08-01,2021-11-10,17386,6016,11370
500824,Company_80,2022-06-09,2022-08-12,2022-11-20,17548,11372,6176
500825,Company_80,2023-03-22,2023-05-07,2023-08-14,7610,390,7220
500826,Company_80,2023-09-22,2023-10-19,2024-04-02,23077,5891,17186
500827,Company_80,2021-04-27,2021-07-27,2022-01-31,19460,7528,11932
500828,Company_81,2023-02-21,2023-04-01,2023-08-03,11312,2778,8534
500829,Company_81,2022-05-05,2022-08-08,2022-10-01,6253,3519,2734
500830,Company_81,2022-03-01,2022-03-31,2022-06-09,17805,4404,13401
500831,Company_81,2023-11-26,2024-02-04,2024-02-08,10123,3887,6236
500832,Company_81,2022-07-04,2022-10-04,2022-11-01,4261,2372,1889
500833,Company_81,2023-01-09,2023-01-28,2023-03-19,19513,11731,7782
500834,Company_81,2023-03-10,2023-04-28,2023-08-26,8113,5706,2407
500835,Company_81,2021-02-06,2021-04-16,2021-07-10,5345,2252,3093
500836,Company_81,2020-10-08,2020-12-17,2021-01-11,18427,15260,3167
500837,Company_81,2020-05-29,2020-06-16,2020-10-10,22539,10711,11828
500838,Company_81,2023-08-16,2023-09-04,2024-01-07,13119,1996,11123
500839,Company_82,2021-07-21,2021-10-04,2021-12-14,15157,14139,1018
500840,Company_82,2022-06-05,2022-09-13,2022-10-25,11321,2905,8416
500841,Company_82,2022-05-26,2022-09-09,2023-02-01,20293,18880,1413
500842,Company_82,2023-12-20,2024-03-07,2024-08-08,24772,1024,23748
500843,Company_82,2021-02-22,2021-03-07,2021-05-26,8078,6654,1424
500844,Company_82,2022-05-28,2022-09-10,2023-02-14,16637,4798,11839
500845,Company_82,2023-06-24,2023-07-21,2023-10-27,11951,11797,154
500846,Company_82,2022-08-09,2022-11-29,2023-04-15,7565,5055,2510
500847,Company_82,2021-05-09,2021-08-17,2021-11-24,8761,7802,959
500848,Company_82,2022-09-20,2022-11-06,2023-04-16,21606,13996,7610
500849,Company_82,2021-01-23,2021-05-03,2021-09-16,24328,18911,5417
500850,Company_82,2022-11-23,2023-01-30,2023-04-28,11364,4488,6876
500851,Company_82,2020-02-19,2020-06-10,2020-08-16,4610,4160,450
500852,Company_82,2023-02-05,2023-04-04,2023-08-16,19469,4672,14797
500853,Company_82,2021-07-15,2021-11-03,2022-03-27,1378,1178,200
500854,Company_82,2023-12-16,2024-02-01,2024-07-24,14264,3868,10396
500855,Company_82,2020-10-10,2020-12-08,2021-02-11,17587,4814,12773
500856,Company_83,2021-09-27,2021-12-03,2022-04-12,6077,2732,3345
500857,Company_83,2020-02-23,2020-05-03,2020-10-06,22197,17383,4814
500858,Company_83,2022-02-20,2022-06-18,2022-08-04,3341,2682,659
500859,Company_83,2023-06-30,2023-09-09,2024-02-16,23877,10275,13602
500860,Company_83,2023-11-16,2023-12-02,2024-05-09,23448,19135,4313
500861,Company_83,2021-01-13,2021-02-09,2021-04-07,6260,3302,2958
500862,Company_83,2022-10-31,2022-12-30,2023-02-21,7339,1365,5974
500863,Company_83,2022-09-11,2022-12-06,2022-12-11,3871,1126,2745
500864,Company_83,2021-12-23,2022-01-13,2022-06-15,8520,4649,3871
500865,Company_83,2020-12-07,2021-03-22,2021-06-22,17060,10296,6764
500866,Company_83,2022-10-04,2022-12-02,2023-04-19,23179,13281,9898
500867,Company_83,2023-12-05,2024-02-01,2024-03-28,18066,2548,15518
500868,Company_83,2022-04-08,2022-06-28,2022-11-06,13683,4860,8823
500869,Company_83,2021-09-16,2021-12-06,2022-06-08,5987,3220,2767
500870,Company_84,2024-02-03,2024-04-07,2024-10-11,14652,10475,4177
500871,Company_84,2021-02-11,2021-02-23,2021-08-11,10679,2331,8348
500872,Company_84,2020-06-16,2020-08-11,2021-02-08,993,866,127
500873,Company_84,2020-03-29,2020-07-11,2021-01-10,5403,824,4579
500874,Company_84,2023-04-04,2023-06-18,2023-06-30,22400,12056,10344
500875,Company_84,2022-02-28,2022-05-08,2022-06-28,18370,11499,6871
500876,Company_84,2021-11-23,2021-12-08,2022-04-03,19012,12920,6092
500877,Company_84,2023-05-28,2023-09-11,2023-11-21,17539,16295,1244
500878,Company_84,2022-09-14,2022-09-27,2023-03-18,4383,851,3532
500879,Company_84,2022-08-01,2022-08-25,2022-10-26,12183,8449,3734
500880,Company_84,2022-05-16,2022-09-11,2023-02-22,1445,171,1274
500881,Company_84,2021-05-29,2021-06-09,2021-09-16,886,408,478
500882,Company_84,2022-02-22,2022-04-28,2022-07-02,18737,11347,7390
500883,Company_84,2021-08-11,2021-11-12,2022-03-03,4447,207,4240
500884,Company_84,2022-06-10,2022-07-22,2023-01-18,22025,18742,3283
500885,Company_84,2020-08-19,2020-09-14,2020-12-10,4740,2215,2525
500886,Company_84,2022-07-05,2022-09-24,2023-03-18,14221,3507,10714
500887,Company_85,2022-07-29,2022-09-23,2022-10-04,2308,389,1919
500888,Company_85,2021-04-29,2021-07-11,2021-09-17,16136,6608,9528
500889,Company_85,2023-01-08,2023-04-28,2023-06-21,23480,15451,8029
500890,Company_85,2021-05-01,2021-07-14,2021-08-09,3380,2378,1002
500891,Company_85,2023-10-10,2024-01-25,2024-05-21,17874,14656,3218
500892,Company_85,2021-07-18,2021-07-31,2021-11-13,22422,21362,1060
500893,Company_85,2023-02-13,2023-06-09,2023-07-11,20956,13988,6968
500894,Company_85,2021-12-02,2022-01-28,2022-02-15,24568,16778,7790
500895,Company_85,2023-06-16,2023-09-15,2023-10-02,7318,800,6518
500896,Company_85,2022-02-25,2022-05-02,2022-11-10,16245,1012,15233
500897,Company_85,2022-01-08,2022-02-02,2022-04-30,4232,3147,1085
500898,Company_85,2020-04-16,2020-06-20,2020-11-24,20714,3687,17027
500899,Company_85,2020-10-25,2021-02-07,2021-06-27,3661,2086,1575
500900,Company_85,2022-02-02,2022-02-18,2022-03-13,5217,3905,1312
500901,Company_85,2020-12-16,2021-03-30,2021-05-14,9380,1440,7940
500902,Company_85,2020-06-01,2020-08-12,2020-09-05,21360,14323,7037
500903,Company_85,2021-10-17,2022-01-28,2022-08-09,1917,72,1845
500904,Company_85,2023-08-27,2023-10-17,2024-02-18,14543,8235,6308
500905,Company_85,2021-02-15,2021-03-01,2021-08-14,13061,9093,3968
500906,Company_86,2022-05-26,2022-07-22,2023-01-20,3171,2742,429
500907,Company_86,2023-12-06,2024-02-02,2024-02-23,23958,12540,11418
500908,Company_86,2021-10-07,2022-01-14,2022-07-08,22615,1737,20878
500909,Company_86,2021-03-07,2021-04-08,2021-09-08,19172,17322,1850
500910,Company_86,2022-04-21,2022-06-28,2022-07-15,14616,11189,3427
500911,Company_86,2023-08-13,2023-10-15,2024-02-26,7749,4693,3056
500912,Company_86,2022-09-13,2022-11-26,2022-12-27,2699,2610,89
500913,Company_86,2021-08-22,2021-09-05,2021-12-03,4032,510,3522
500914,Company_86,2020-10-20,2020-12-13,2021-04-06,5816,1618,4198
500915,Company_86,2023-05-09,2023-08-24,2024-02-18,4881,2073,2808
500916,Company_86,2023-10-26,2023-11-17,2024-05-26,16224,9174,7050
500917,Company_86,2023-02-21,2023-04-02,2023-08-16,16010,15244,766
500918,Company_86,2020-12-22,2021-04-05,2021-06-25,16812,2260,14552
500919,Company_86,2022-03-20,2022-06-29,2022-07-17,19290,14712,4578
500920,Company_86,2020-12-21,2021-04-16,2021-07-18,9151,8386,765
500921,Company_86,2023-12-12,2024-02-29,2024-06-25,19365,11595,7770
500922,Company_87,2023-04-29,2023-06-05,2023-08-10,24124,21129,2995
500923,Company_87,2020-05-09,2020-09-03,2021-02-21,6751,2938,3813
500924,Company_87,2023-08-27,2023-10-26,2023-11-21,10302,5518,4784
500925,Company_87,2020-10-09,2020-11-30,2021-01-08,13111,2411,10700
500926,Company_88,2020-01-23,2020-02-08,2020-05-14,7784,3019,4765
500927,Company_88,2022-11-24,2022-12-18,2023-01-26,9807,129,9678
500928,Company_88,2021-03-25,2021-05-14,2021-10-07,15109,14308,801
500929,Company_88,2021-07-21,2021-08-09,2022-01-10,14191,8931,5260
500930,Company_89,2022-08-29,2022-11-01,2023-01-10,15165,5811,9354
500931,Company_89,2022-03-18,2022-06-19,2022-08-24,12333,5767,6566
500932,Company_89,2020-11-30,2020-12-20,2021-01-20,20573,12262,8311
500933,Company_89,2021-01-13,2021-03-20,2021-06-07,19884,16556,3328
500934,Company_89,2023-05-30,2023-07-26,2023-09-01,13177,9576,3601
500935,Company_89,2021-09-02,2021-12-30,2022-01-18,5716,5016,700
500936,Company_89,2021-11-21,2022-03-20,2022-06-20,5376,3652,1724
500937,Company_89,2022-11-16,2022-12-14,2023-04-28,10454,1217,9237
500938,Company_89,2023-09-03,2023-12-31,2024-01-22,20736,20067,669
500939,Company_89,2022-12-22,2023-02-23,2023-06-17,8175,874,7301
500940,Company_89,2022-06-08,2022-09-14,2022-11-14,1391,798,593
500941,Company_89,2022-09-17,2022-11-03,2023-02-18,21908,21774,134
500942,Company_89,2022-07-26,2022-11-22,2022-12-18,8825,5183,3642
500943,Company_89,2021-07-30,2021-10-21,2021-11-03,9652,5029,4623
500944,Company_89,2024-01-05,2024-04-05,2024-10-14,12476,7227,5249
500945,Company_89,2023-06-15,2023-08-22,2023-08-25,2423,199,2224
500946,Company_90,2022-06-04,2022-08-02,2022-12-03,14120,11455,2665
500947,Company_90,2022-10-30,2023-02-22,2023-03-16,13251,7648,5603
500948,Company_90,2022-04-06,2022-05-26,2022-06-05,6794,4097,2697
500949,Company_90,2022-06-23,2022-10-02,2022-11-05,24645,64,24581
500950,Company_90,2020-11-03,2021-01-31,2021-05-18,12400,3426,8974
500951,Company_90,2023-09-20,2023-11-14,2024-05-16,24496,1855,22641
500952,Company_90,2020-06-03,2020-06-22,2020-10-21,21340,6225,15115
500953,Company_90,2023-02-15,2023-05-08,2023-10-12,19744,19546,198
500954,Company_90,2023-06-28,2023-10-08,2024-01-04,17450,6233,11217
500955,Company_90,2021-12-19,2022-01-07,2022-06-30,10209,9550,659
500956,Company_90,2023-09-09,2023-12-29,2024-03-29,24452,8870,15582
500957,Company_90,2023-05-21,2023-07-09,2023-10-06,24458,14780,9678
500958,Company_90,2022-11-22,2023-01-28,2023-05-02,5105,4876,229
500959,Company_90,2022-08-28,2022-10-29,2023-03-10,15292,10243,5049
500960,Company_91,2022-03-08,2022-05-17,2022-08-21,22711,3756,18955
500961,Company_91,2022-10-15,2023-01-26,2023-04-16,23729,9916,13813
500962,Company_91,2021-01-25,2021-05-17,2021-09-06,24592,23311,1281
500963,Company_91,2020-04-19,2020-05-19,2020-12-03,20071,3143,16928
500964,Company_91,2023-10-12,2023-11-04,2024-01-09,1830,1420,410
500965,Company_91,2023-10-27,2023-11-20,2024-03-17,19382,7250,12132
500966,Company_91,2020-02-25,2020-05-19,2020-06-10,9094,8352,742
500967,Company_91,2021-08-14,2021-09-25,2021-11-25,20903,6744,14159
500968,Company_91,2021-12-28,2022-02-12,2022-03-09,4235,177,4058
500969,Company_91,2021-08-22,2021-09-17,2021-11-09,5993,1451,4542
500970,Company_91,2020-04-25,2020-07-20,2020-08-17,5469,69,5400
500971,Company_91,2023-10-10,2023-11-10,2024-04-16,8460,5345,3115
500972,Company_91,2024-02-02,2024-03-29,2024-10-03,22280,21771,509
500973,Company_91,2022-08-23,2022-10-25,2023-01-18,3665,925,2740
500974,Company_91,2020-03-10,2020-06-16,2020-11-23,16341,15496,845
500975,Company_91,2022-01-13,2022-01-24,2022-02-13,1678,953,725
500976,Company_91,2021-02-16,2021-04-06,2021-06-05,4774,1628,3146
500977,Company_91,2020-02-11,2020-02-25,2020-06-20,11383,5292,6091
500978,Company_91,2021-10-22,2021-11-30,2022-03-20,10477,8829,1648
500979,Company_92,2021-02-15,2021-05-13,2021-11-26,15982,6915,9067
500980,Company_92,2023-12-24,2024-02-07,2024-03-27,15105,9481,5624
500981,Company_92,2022-12-16,2023-03-06,2023-05-24,11154,6554,4600
500982,Company_92,2023-04-26,2023-08-21,2024-03-02,14824,2062,12762
500983,Company_92,2023-02-12,2023-05-21,2023-09-29,3814,142,3672
500984,Company_92,2023-06-19,2023-06-30,2023-12-16,1225,151,1074
500985,Company_92,2021-04-11,2021-06-15,2021-09-13,6780,5982,798
500986,Company_92,2021-10-06,2021-11-18,2022-01-21,3247,1321,1926
500987,Company_92,2021-01-22,2021-02-06,2021-07-16,5644,198,5446
500988,Company_92,2020-12-16,2021-04-09,2021-07-10,10192,7912,2280
500989,Company_92,2023-12-29,2024-02-29,2024-09-15,15177,13434,1743
500990,Company_93,2021-05-22,2021-07-08,2021-09-14,1693,134,1559
500991,Company_93,2023-09-08,2023-12-05,2024-03-12,13177,7389,5788
500992,Company_93,2020-01-26,2020-04-08,2020-05-27,21499,19656,1843
500993,Company_93,2021-10-11,2021-12-14,2022-03-04,6524,3894,2630
500994,Company_93,2020-09-12,2020-09-23,2021-01-19,19204,16952,2252
500995,Company_93,2023-04-07,2023-06-03,2023-08-17,3785,477,3308
500996,Company_94,2022-02-24,2022-05-23,2022-07-18,8819,1160,7659
500997,Company_94,2020-12-28,2021-02-21,2021-03-17,2021,1488,533
500998,Company_94,2023-08-15,2023-11-15,2024-05-02,9071,8874,197
500999,Company_94,2022-01-26,2022-02-07,2022-07-04,11059,6183,4876
501000,Company_94,2021-11-09,2022-03-04,2022-07-05,4852,2454,2398
501001,Company_94,2020-03-15,2020-05-13,2020-07-17,3011,1059,1952
501002,Company_94,2022-03-15,2022-05-13,2022-05-19,19963,10150,9813
501003,Company_94,2023-01-20,2023-05-04,2023-11-04,10770,10172,598
501004,Company_94,2020-08-31,2020-12-17,2021-02-05,15415,12850,2565
501005,Company_94,2021-07-01,2021-09-02,2021-12-29,23855,398,23457
501006,Company_94,2020-12-29,2021-01-10,2021-02-22,18560,16675,1885
501007,Company_94,2020-04-29,2020-08-26,2020-09-09,14015,1338,12677
501008,Company_94,2023-11-26,2024-02-02,2024-08-04,7824,3157,4667
501009,Company_94,2023-10-07,2023-12-23,2024-01-14,14544,11050,3494
501010,Company_94,2023-04-27,2023-08-04,2024-02-15,15513,10650,4863
501011,Company_94,2023-03-08,2023-05-09,2023-08-13,22025,11273,10752
501012,Company_95,2023-02-05,2023-03-24,2023-05-10,8437,280,8157
501013,Company_95,2022-07-13,2022-08-27,2022-12-17,23943,6736,17207
501014,Company_95,2021-09-17,2021-12-30,2022-02-25,24983,5399,19584
501015,Company_95,2022-06-21,2022-10-13,2022-10-14,21768,449,21319
501016,Company_96,2020-04-26,2020-06-28,2020-09-27,15043,6300,8743
501017,Company_96,2022-09-03,2022-12-17,2023-03-04,8322,1336,6986
501018,Company_96,2022-03-06,2022-04-14,2022-07-11,12209,10157,2052
501019,Company_96,2021-02-05,2021-05-03,2021-11-13,13849,4973,8876
501020,Company_96,2022-11-12,2022-12-04,2023-03-13,1343,1212,131
501021,Company_96,2023-12-21,2024-01-22,2024-07-24,21744,19287,2457
501022,Company_96,2020-03-12,2020-06-30,2020-08-09,8632,1714,6918
501023,Company_96,2020-10-13,2020-12-18,2021-06-05,11220,11105,115
501024,Company_96,2021-08-24,2021-10-20,2022-03-09,6595,131,6464
501025,Company_96,2023-08-03,2023-11-13,2023-12-09,7241,3712,3529
501026,Company_96,2023-03-19,2023-06-10,2023-09-02,23634,16685,6949
501027,Company_96,2021-03-01,2021-04-14,2021-07-12,20744,2798,17946
501028,Company_96,2020-02-16,2020-05-13,2020-06-13,8460,8238,222
501029,Company_96,2022-10-30,2022-12-13,2023-05-26,5447,1276,4171
501030,Company_96,2021-01-20,2021-02-13,2021-07-03,13578,3628,9950
501031,Company_96,2020-09-06,2020-12-06,2020-12-12,7383,3657,3726
501032,Company_97,2022-04-21,2022-08-06,2022-10-02,18484,9491,8993
501033,Company_97,2022-12-11,2023-02-19,2023-07-21,16376,7537,8839
501034,Company_97,2023-07-08,2023-08-12,2023-11-19,18473,218,18255
501035,Company_97,2022-07-22,2022-08-16,2022-10-13,9012,5566,3446
501036,Company_97,2021-08-01,2021-10-19,2021-12-02,10238,10014,224
501037,Company_97,2020-11-20,2021-01-02,2021-07-15,23769,14598,9171
501038,Company_97,2024-01-19,2024-04-18,2024-09-20,9400,5998,3402
501039,Company_97,2021-04-13,2021-06-09,2021-06-11,1208,1161,47
501040,Company_97,2022-08-20,2022-11-01,2023-01-03,7157,949,6208
501041,Company_97,2022-10-19,2022-12-07,2023-03-22,24676,3121,21555
501042,Company_97,2020-03-31,2020-06-21,2020-12-18,7448,3919,3529
501043,Company_97,2021-06-30,2021-08-20,2021-08-30,13904,4192,9712
501044,Company_98,2023-03-30,2023-04-20,2023-05-03,19946,19051,895
501045,Company_98,2022-08-26,2022-09-11,2022-11-22,18730,7618,11112
501046,Company_98,2021-10-01,2021-10-20,2022-03-03,24991,3272,21719
501047,Company_98,2023-05-23,2023-07-27,2023-09-13,9045,6429,2616
501048,Company_98,2020-01-18,2020-02-26,2020-03-29,5167,2277,2890
501049,Company_98,2022-03-17,2022-04-24,2022-05-06,4821,4283,538
501050,Company_98,2020-10-29,2021-01-16,2021-07-27,18867,2559,16308
501051,Company_98,2022-09-14,2022-09-25,2022-11-08,5667,2797,2870
501052,Company_98,2021-06-14,2021-10-04,2021-11-09,1503,579,924
501053,Company_98,2022-12-24,2023-04-08,2023-07-17,14072,12800,1272
501054,Company_99,2022-11-16,2022-12-24,2023-01-24,17738,10455,7283
501055,Company_99,2021-01-21,2021-02-13,2021-04-21,3970,3412,558
501056,Company_99,2021-09-18,2021-12-16,2022-05-08,17562,12947,4615
501057,Company_99,2020-05-24,2020-06-13,2020-07-27,1365,93,1272
501058,Company_99,2022-06-24,2022-09-20,2023-04-04,14071,625,13446
501059,Company_99,2020-07-23,2020-11-08,2021-01-29,15176,228,14948
501060,Company_100,2022-10-05,2022-12-04,2023-03-12,3554,320,3234
501061,Company_100,2022-11-08,2023-01-07,2023-04-12,21079,8958,12121
501062,Company_100,2022-07-12,2022-07-24,2022-10-06,8690,1710,6980
501063,Company_100,2020-11-30,2021-02-09,2021-03-13,12874,9612,3262
501064,Company_100,2023-12-13,2024-01-12,2024-03-18,19501,650,18851
501065,Company_100,2022-11-28,2023-03-02,2023-04-14,2157,1206,951
501066,Company_100,2020-10-25,2021-01-22,2021-01-26,2470,178,2292
501067,Company_100,2023-12-23,2024-03-14,2024-06-22,4743,3829,914
501068,Company_100,2022-09-06,2022-12-09,2023-03-07,6372,5546,826
501069,Company_100,2022-06-01,2022-06-15,2022-07-05,10143,7476,2667
501070,Company_100,2022-04-05,2022-05-12,2022-10-07,8899,7789,1110
501071,Company_100,2022-05-14,2022-07-14,2022-10-20,16591,9424,7167
501072,Company_100,2023-07-05,2023-09-09,2023-12-30,15682,12203,3479
501073,Company_100,2023-11-07,2024-01-22,2024-03-13,10945,10431,514
501074,Company_100,2023-05-10,2023-07-12,2023-09-24,22367,8528,13839
501075,Company_100,2022-09-13,2022-11-27,2023-04-04,3266,1572,1694
501076,Company_100,2022-06-21,2022-07-05,2022-10-21,16499,16385,114
501077,Company_100,2021-12-11,2021-12-28,2022-03-30,4702,4018,684
501078,Company_100,2021-05-25,2021-06-11,2021-07-10,4381,3019,1362
501079,Company_101,2022-10-29,2023-01-19,2023-07-28,13849,5031,8818
501080,Company_101,2020-08-17,2020-10-04,2021-04-09,15620,13183,2437
501081,Company_101,2023-12-27,2024-01-26,2024-06-24,14653,8743,5910
501082,Company_101,2020-02-18,2020-04-06,2020-04-29,19714,8167,11547
501083,Company_101,2022-06-25,2022-07-29,2022-11-20,2392,2267,125
501084,Company_102,2022-02-03,2022-04-05,2022-06-15,14692,7933,6759
501085,Company_102,2021-06-27,2021-09-23,2021-12-24,20487,16055,4432
501086,Company_102,2021-05-15,2021-07-16,2021-09-01,24337,12678,11659
501087,Company_102,2020-06-15,2020-09-02,2020-10-03,21284,13884,7400
501088,Company_102,2020-10-28,2020-11-25,2021-06-07,24502,6533,17969
501089,Company_102,2021-07-30,2021-10-04,2022-03-13,7623,3674,3949
501090,Company_102,2022-09-27,2022-12-31,2023-07-02,3094,1268,1826
501091,Company_102,2020-08-07,2020-10-06,2021-01-18,19108,3438,15670
501092,Company_102,2023-01-17,2023-03-15,2023-09-23,18279,2377,15902
501093,Company_102,2021-12-11,2022-03-07,2022-06-10,7636,6209,1427
501094,Company_102,2022-08-25,2022-10-18,2023-03-14,4500,1072,3428
501095,Company_102,2022-01-30,2022-04-01,2022-07-04,15341,11227,4114
501096,Company_102,2021-12-03,2022-03-11,2022-09-02,21276,11542,9734
501097,Company_102,2020-01-16,2020-03-17,2020-08-22,22987,22807,180
501098,Company_103,2023-06-19,2023-08-07,2024-01-13,20776,14971,5805
501099,Company_103,2021-08-22,2021-11-18,2022-02-23,4059,1084,2975
501100,Company_103,2020-11-16,2021-01-24,2021-02-05,14548,8020,6528
501101,Company_103,2024-01-29,2024-04-21,2024-09-20,11233,9222,2011
501102,Company_103,2021-05-25,2021-08-01,2021-11-20,2409,960,1449
501103,Company_103,2020-11-07,2020-11-23,2021-02-11,4124,57,4067
501104,Company_103,2022-01-15,2022-05-03,2022-10-05,3286,1827,1459
501105,Company_103,2022-10-12,2023-01-11,2023-02-23,21035,12051,8984
501106,Company_103,2023-12-16,2024-03-23,2024-08-17,3060,1680,1380
501107,Company_103,2023-03-29,2023-06-20,2023-10-21,3418,3325,93
501108,Company_103,2023-11-05,2024-01-25,2024-02-21,13196,4704,8492
501109,Company_103,2022-12-27,2023-01-20,2023-02-07,15960,1781,14179
501110,Company_103,2023-12-20,2024-03-31,2024-09-06,19560,18840,720
501111,Company_103,2021-10-02,2021-11-25,2021-11-27,5445,2116,3329
501112,Company_104,2020-12-14,2021-02-02,2021-04-17,11584,1704,9880
501113,Company_104,2022-09-13,2022-12-07,2023-02-07,6738,5995,743
501114,Company_104,2023-12-18,2024-04-01,2024-04-05,12413,7521,4892
501115,Company_104,2022-03-09,2022-07-01,2022-12-27,10214,6926,3288
501116,Company_104,2020-12-20,2021-02-07,2021-02-28,24710,9429,15281
501117,Company_104,2021-01-21,2021-02-08,2021-02-27,16118,7385,8733
501118,Company_104,2023-09-03,2023-10-24,2024-02-05,12304,848,11456
501119,Company_104,2021-12-18,2022-01-07,2022-02-01,18061,608,17453
501120,Company_104,2023-01-17,2023-02-11,2023-06-11,2345,571,1774
501121,Company_104,2023-08-15,2023-11-28,2024-02-06,6514,5308,1206
501122,Company_104,2023-01-28,2023-03-21,2023-06-05,4242,918,3324
501123,Company_104,2021-01-19,2021-01-29,2021-05-08,2585,2251,334
501124,Company_104,2021-08-08,2021-10-01,2021-12-21,17383,9317,8066
501125,Company_104,2021-12-24,2022-04-02,2022-09-20,8668,7446,1222
501126,Company_104,2020-04-07,2020-05-14,2020-08-29,5158,2797,2361
501127,Company_104,2021-01-25,2021-03-21,2021-09-06,16944,884,16060
501128,Company_104,2023-08-09,2023-11-12,2024-03-07,10659,6314,4345
501129,Company_104,2022-03-13,2022-04-30,2022-09-02,4240,2565,1675
501130,Company_104,2021-08-10,2021-10-15,2022-02-22,10988,4743,6245
501131,Company_105,2023-08-05,2023-11-19,2024-05-22,1341,274,1067
501132,Company_105,2020-07-21,2020-08-26,2020-11-24,16791,14073,2718
501133,Company_105,2023-06-03,2023-09-04,2023-11-11,17557,14934,2623
501134,Company_105,2022-01-01,2022-02-06,2022-03-06,14448,1036,13412
501135,Company_105,2023-12-27,2024-04-14,2024-10-22,5093,2863,2230
501136,Company_105,2021-05-25,2021-08-11,2022-01-29,9758,7510,2248
501137,Company_105,2021-08-04,2021-11-26,2022-03-31,10997,2323,8674
501138,Company_105,2022-01-12,2022-05-01,2022-05-20,15330,8526,6804
501139,Company_105,2023-11-28,2024-01-04,2024-05-05,3421,3316,105
501140,Company_105,2020-12-18,2021-02-25,2021-08-16,8060,4740,3320
501141,Company_105,2021-03-23,2021-06-21,2021-08-15,10366,5558,4808
501142,Company_105,2021-03-22,2021-06-19,2021-12-12,1822,1394,428
501143,Company_105,2022-03-22,2022-07-01,2022-12-19,4738,2236,2502
501144,Company_105,2023-01-08,2023-01-23,2023-02-17,18288,11092,7196
501145,Company_105,2023-09-17,2023-12-17,2024-03-31,884,711,173
501146,Company_105,2021-08-17,2021-09-02,2021-12-01,10074,2869,7205
501147,Company_105,2021-12-22,2022-01-10,2022-01-25,14218,9506,4712
501148,Company_106,2021-12-01,2022-01-17,2022-05-10,16019,9042,6977
501149,Company_106,2020-11-21,2021-02-18,2021-05-03,19162,18035,1127
501150,Company_106,2021-09-10,2021-11-09,2021-11-29,10567,8994,1573
501151,Company_106,2020-07-03,2020-07-17,2020-12-19,10869,1969,8900
501152,Company_106,2021-06-06,2021-08-31,2021-09-08,5761,109,5652
501153,Company_106,2021-05-28,2021-08-28,2021-12-10,22305,11660,10645
501154,Company_106,2021-01-06,2021-04-25,2021-09-05,5896,3439,2457
501155,Company_106,2021-11-08,2021-12-21,2022-01-13,22497,15605,6892
501156,Company_106,2021-01-24,2021-03-07,2021-06-04,11429,1115,10314
501157,Company_106,2023-06-23,2023-09-25,2023-11-03,21087,10316,10771
501158,Company_107,2020-03-19,2020-06-29,2020-11-05,2527,1248,1279
501159,Company_107,2020-09-13,2020-10-16,2020-12-24,11253,9467,1786
501160,Company_107,2020-10-04,2020-12-08,2021-05-16,22626,11101,11525
501161,Company_108,2020-03-19,2020-05-27,2020-10-10,18185,5712,12473
501162,Company_108,2023-07-08,2023-09-17,2023-10-20,16612,4377,12235
501163,Company_108,2022-10-09,2022-12-04,2023-03-15,18531,3367,15164
501164,Company_108,2020-03-04,2020-05-13,2020-11-06,3663,1263,2400
501165,Company_108,2021-04-03,2021-06-10,2021-08-28,9531,8294,1237
501166,Company_108,2021-08-14,2021-09-24,2021-11-05,2787,156,2631
501167,Company_108,2021-01-26,2021-05-25,2021-10-31,1972,1799,173
501168,Company_108,2020-03-11,2020-03-23,2020-07-04,8638,4394,4244
501169,Company_108,2023-04-05,2023-06-05,2023-09-08,1611,858,753
501170,Company_108,2021-09-15,2021-11-25,2022-03-12,6020,2619,3401
501171,Company_108,2022-01-22,2022-04-07,2022-09-20,23390,4168,19222
501172,Company_108,2021-04-28,2021-05-11,2021-06-16,1576,641,935
501173,Company_108,2022-05-07,2022-08-11,2022-12-18,23773,7192,16581
501174,Company_108,2020-09-10,2020-11-16,2021-02-08,2263,981,1282
501175,Company_108,2023-10-01,2023-11-07,2024-04-19,3877,232,3645
501176,Company_108,2022-03-20,2022-07-07,2022-09-17,11752,11277,475
501177,Company_109,2022-08-27,2022-09-30,2022-12-16,14969,7158,7811
501178,Company_109,2021-09-23,2021-12-15,2022-05-11,18222,11560,6662
501179,Company_109,2021-10-13,2022-01-16,2022-05-27,6501,2331,4170
501180,Company_109,2021-08-20,2021-11-30,2022-01-08,11127,5635,5492
501181,Company_109,2024-01-11,2024-03-02,2024-04-29,6067,790,5277
501182,Company_109,2022-06-18,2022-09-23,2023-03-27,24646,4215,20431
501183,Company_109,2021-08-26,2021-10-12,2021-10-24,12278,7411,4867
501184,Company_109,2021-01-16,2021-03-22,2021-05-18,827,422,405
501185,Company_109,2020-11-12,2021-01-27,2021-02-09,12529,9332,3197
501186,Company_109,2022-07-04,2022-08-06,2022-08-21,7983,3159,4824
501187,Company_109,2020-02-11,2020-04-03,2020-10-11,7221,3193,4028
501188,Company_109,2020-02-25,2020-04-09,2020-08-29,23298,690,22608
501189,Company_109,2022-12-31,2023-04-11,2023-06-16,12478,4712,7766
501190,Company_109,2020-12-11,2021-01-11,2021-02-06,1419,1329,90
501191,Company_109,2020-06-04,2020-07-29,2021-01-07,23102,13564,9538
501192,Company_110,2021-01-08,2021-04-29,2021-06-16,20928,9178,11750
501193,Company_110,2022-01-31,2022-04-05,2022-04-29,2389,1570,819
501194,Company_110,2021-11-03,2022-02-26,2022-03-22,18624,15140,3484
501195,Company_110,2023-07-30,2023-11-01,2024-02-23,13014,11149,1865
501196,Company_110,2020-03-08,2020-04-27,2020-06-27,4345,4325,20
501197,Company_110,2022-06-08,2022-08-09,2023-01-10,12209,816,11393
501198,Company_110,2021-11-22,2022-01-23,2022-07-10,19216,307,18909
501199,Company_110,2022-12-03,2023-02-11,2023-03-30,18855,7245,11610
501200,Company_110,2020-02-04,2020-05-05,2020-08-30,18583,194,18389
501201,Company_110,2020-11-02,2020-12-17,2021-06-08,16262,11739,4523
501202,Company_110,2023-05-13,2023-07-11,2023-09-29,14924,6081,8843
501203,Company_111,2022-01-25,2022-04-02,2022-07-06,16740,5804,10936
501204,Company_111,2023-03-06,2023-05-26,2023-06-16,16058,5640,10418
501205,Company_111,2023-07-31,2023-10-18,2023-12-14,22588,6874,15714
501206,Company_111,2020-01-14,2020-03-12,2020-07-02,21075,230,20845
501207,Company_111,2021-09-28,2021-11-01,2021-12-29,9001,8565,436
501208,Company_111,2020-06-07,2020-08-24,2020-12-25,23814,21527,2287
501209,Company_111,2021-08-03,2021-10-05,2021-11-15,20292,11383,8909
501210,Company_111,2020-02-19,2020-05-18,2020-08-20,16916,10828,6088
501211,Company_111,2020-03-06,2020-04-01,2020-05-27,18277,17918,359
501212,Company_111,2020-07-22,2020-11-16,2021-01-22,21972,15839,6133
501213,Company_111,2020-08-09,2020-11-26,2021-02-19,8585,8107,478
501214,Company_111,2022-02-12,2022-03-24,2022-09-10,18426,2623,15803
501215,Company_111,2022-09-14,2022-10-04,2022-12-13,16616,9922,6694
501216,Company_111,2022-03-30,2022-05-18,2022-08-23,2998,95,2903
501217,Company_111,2021-07-15,2021-09-27,2022-04-04,23370,4534,18836
501218,Company_111,2021-04-03,2021-05-17,2021-08-23,24774,11813,12961
501219,Company_112,2020-05-18,2020-09-06,2020-10-09,15791,7836,7955
501220,Company_112,2020-10-01,2020-11-06,2021-04-17,19382,4656,14726
501221,Company_112,2022-08-17,2022-10-17,2023-01-19,19948,13407,6541
501222,Company_112,2023-12-03,2024-03-25,2024-08-03,4345,1544,2801
501223,Company_112,2022-06-27,2022-08-01,2022-08-09,10026,9338,688
501224,Company_112,2023-06-03,2023-08-08,2024-02-20,5546,2241,3305
501225,Company_112,2022-08-18,2022-11-11,2022-12-06,8830,7963,867
501226,Company_112,2020-08-30,2020-10-25,2021-04-04,17089,2086,15003
501227,Company_112,2021-08-13,2021-08-25,2021-09-26,23612,8419,15193
501228,Company_112,2022-06-18,2022-09-09,2022-11-02,15004,2266,12738
501229,Company_112,2020-10-29,2021-01-16,2021-05-11,16225,10506,5719
501230,Company_112,2021-01-05,2021-04-29,2021-06-29,12177,5752,6425
501231,Company_113,2022-06-20,2022-09-23,2023-04-07,4998,4599,399
501232,Company_113,2021-09-23,2021-10-20,2021-12-31,13283,11633,1650
501233,Company_113,2021-07-07,2021-09-22,2022-01-02,17279,11422,5857
501234,Company_113,2021-04-11,2021-06-07,2021-10-14,21057,10062,10995
501235,Company_113,2020-11-28,2020-12-12,2021-02-20,14207,10676,3531
501236,Company_113,2023-11-17,2024-02-27,2024-07-08,12299,4177,8122
501237,Company_113,2023-09-22,2023-12-25,2024-04-28,5658,3497,2161
501238,Company_113,2022-06-01,2022-09-26,2022-10-02,23014,5625,17389
501239,Company_113,2020-04-29,2020-07-09,2020-07-30,24318,15334,8984
501240,Company_114,2020-08-29,2020-10-06,2020-11-05,18135,17754,381
501241,Company_114,2024-01-20,2024-03-19,2024-09-08,2260,1339,921
501242,Company_114,2023-12-12,2024-04-05,2024-07-01,9984,8179,1805
501243,Company_114,2022-09-02,2022-11-14,2023-05-04,8084,6240,1844
501244,Company_114,2020-10-15,2020-12-19,2021-02-20,2142,700,1442
501245,Company_114,2023-08-21,2023-10-15,2023-12-13,5448,692,4756
501246,Company_114,2020-04-01,2020-06-30,2020-12-24,5878,5598,280
501247,Company_114,2022-11-26,2023-03-17,2023-06-23,18363,6970,11393
501248,Company_114,2020-06-14,2020-07-23,2020-12-18,14048,9625,4423
501249,Company_114,2020-02-26,2020-03-10,2020-08-03,13468,13274,194
501250,Company_114,2023-06-02,2023-06-19,2023-09-15,6936,938,5998
501251,Company_114,2023-04-14,2023-06-17,2023-07-18,1196,110,1086
501252,Company_114,2023-03-21,2023-04-16,2023-05-28,16794,8610,8184
501253,Company_114,2021-01-06,2021-03-22,2021-06-02,19641,17629,2012
501254,Company_114,2022-09-09,2022-11-01,2023-04-06,10868,9139,1729
501255,Company_115,2022-12-10,2023-03-24,2023-05-06,5985,4690,1295
501256,Company_115,2023-02-28,2023-06-20,2023-11-29,1522,1179,343
501257,Company_115,2023-09-19,2023-10-15,2023-11-08,20394,13435,6959
501258,Company_115,2022-12-23,2023-03-26,2023-05-08,9315,3612,5703
501259,Company_115,2021-05-01,2021-08-15,2021-08-16,13932,5648,8284
501260,Company_115,2020-06-17,2020-08-16,2020-09-24,2557,2222,335
501261,Company_115,2022-12-02,2023-02-23,2023-05-29,23864,6862,17002
501262,Company_115,2023-02-25,2023-05-11,2023-10-25,3467,2568,899
501263,Company_115,2021-11-25,2021-12-21,2022-05-12,4013,190,3823
501264,Company_115,2021-01-22,2021-02-18,2021-04-12,4792,2127,2665
501265,Company_115,2021-03-03,2021-03-21,2021-06-27,24086,1149,22937
501266,Company_115,2021-03-29,2021-04-19,2021-06-26,13997,6550,7447
501267,Company_115,2023-06-12,2023-06-29,2023-09-30,16161,7238,8923
501268,Company_115,2022-04-24,2022-06-15,2022-10-24,1883,982,901
501269,Company_115,2020-09-01,2020-11-22,2021-05-31,16259,1,16258
501270,Company_115,2022-08-04,2022-09-17,2023-02-09,7148,703,6445
501271,Company_116,2022-03-16,2022-05-11,2022-08-18,8460,8016,444
501272,Company_116,2021-01-08,2021-04-13,2021-09-25,18332,12313,6019
501273,Company_116,2020-08-25,2020-12-05,2020-12-28,3698,56,3642
501274,Company_116,2023-01-04,2023-02-09,2023-07-09,21510,4728,16782
501275,Company_116,2020-07-29,2020-11-08,2021-04-24,22458,19235,3223
501276,Company_116,2022-01-15,2022-04-11,2022-07-29,14769,3734,11035
501277,Company_116,2023-10-02,2024-01-07,2024-02-17,11773,8557,3216
501278,Company_116,2020-07-14,2020-10-05,2020-11-04,23021,20120,2901
501279,Company_116,2022-01-26,2022-03-06,2022-08-27,11566,6235,5331
501280,Company_116,2020-10-06,2020-10-30,2020-11-29,20306,8970,11336
501281,Company_116,2021-01-04,2021-04-19,2021-07-06,7619,2990,4629
501282,Company_116,2023-10-09,2024-01-16,2024-03-25,17303,7010,10293
501283,Company_116,2023-01-26,2023-03-03,2023-09-03,10649,8567,2082
501284,Company_116,2024-01-08,2024-02-09,2024-02-09,8804,2808,5996
501285,Company_116,2023-01-19,2023-02-01,2023-05-06,14018,8011,6007
501286,Company_117,2022-09-07,2022-12-18,2023-04-24,3046,2719,327
501287,Company_117,2020-09-11,2020-12-18,2021-01-02,12638,11040,1598
501288,Company_117,2022-05-07,2022-07-15,2022-12-08,17207,9602,7605
501289,Company_117,2022-11-25,2023-01-02,2023-02-10,2534,2261,273
501290,Company_117,2022-01-15,2022-04-01,2022-05-19,18372,248,18124
501291,Company_117,2023-12-09,2024-02-20,2024-05-22,4605,3146,1459
501292,Company_117,2023-04-12,2023-08-07,2024-01-09,18615,14261,4354
501293,Company_117,2020-01-11,2020-04-02,2020-06-24,16665,3426,13239
501294,Company_117,2023-05-03,2023-08-16,2023-11-27,2625,1426,1199
501295,Company_117,2022-04-17,2022-07-29,2022-12-17,15577,4378,11199
501296,Company_117,2021-08-02,2021-11-02,2022-02-22,822,819,3
501297,Company_117,2023-07-22,2023-08-29,2023-12-24,8226,4322,3904
501298,Company_117,2020-03-28,2020-04-27,2020-06-15,15066,7920,7146
501299,Company_117,2023-04-12,2023-06-03,2023-06-23,6902,6615,287
501300,Company_117,2020-10-20,2021-01-14,2021-07-20,23039,9468,13571
501301,Company_118,2021-02-02,2021-03-07,2021-04-16,6668,1809,4859
501302,Company_118,2020-11-21,2021-01-25,2021-05-29,8877,3864,5013
501303,Company_118,2023-01-29,2023-05-04,2023-07-23,914,49,865
501304,Company_118,2023-05-26,2023-09-04,2023-09-17,20287,10308,9979
501305,Company_118,2021-12-01,2021-12-18,2022-04-04,8634,4698,3936
501306,Company_118,2020-08-12,2020-08-24,2020-09-26,21032,5828,15204
501307,Company_118,2021-04-11,2021-05-12,2021-08-23,3597,1493,2104
501308,Company_118,2023-11-14,2024-01-06,2024-07-22,2976,1682,1294
501309,Company_118,2023-07-02,2023-09-20,2024-01-31,23259,6500,16759
501310,Company_118,2021-08-14,2021-11-14,2022-03-25,4668,174,4494
501311,Company_118,2021-06-03,2021-08-31,2022-02-10,17811,12837,4974
501312,Company_118,2020-11-28,2021-02-22,2021-05-23,12462,5932,6530
501313,Company_118,2023-09-25,2023-11-24,2024-05-07,13586,3001,10585
501314,Company_118,2021-07-02,2021-09-16,2022-03-25,11708,1797,9911
501315,Company_119,2022-10-25,2023-01-16,2023-07-25,1354,1113,241
501316,Company_119,2020-05-16,2020-07-19,2020-12-03,8398,5013,3385
501317,Company_119,2022-03-21,2022-07-07,2022-12-07,11602,4087,7515
501318,Company_120,2023-07-28,2023-08-23,2023-08-27,24025,15855,8170
501319,Company_120,2023-01-15,2023-03-22,2023-04-23,6564,2006,4558
501320,Company_120,2022-07-31,2022-09-25,2022-10-27,14621,3991,10630
501321,Company_120,2023-10-14,2023-11-24,2024-01-10,3976,247,3729
501322,Company_120,2021-11-17,2022-01-12,2022-01-18,7382,5970,1412
501323,Company_120,2021-12-04,2022-02-13,2022-07-22,23819,12853,10966
501324,Company_120,2023-02-28,2023-04-02,2023-09-26,11788,10207,1581
501325,Company_120,2020-08-31,2020-12-13,2021-03-10,1595,131,1464
501326,Company_120,2023-12-17,2024-03-12,2024-08-22,20417,4633,15784
501327,Company_120,2020-05-03,2020-05-25,2020-11-04,6234,3605,2629
501328,Company_120,2020-07-02,2020-07-12,2021-01-14,14312,10984,3328
501329,Company_120,2020-05-09,2020-08-14,2020-12-03,24967,295,24672
501330,Company_120,2020-06-17,2020-08-01,2020-12-03,15506,1734,13772
501331,Company_120,2021-06-16,2021-09-01,2022-02-10,15775,9679,6096
501332,Company_120,2021-07-21,2021-08-23,2022-01-25,9130,2452,6678
501333,Company_120,2024-01-01,2024-03-13,2024-07-18,3397,3127,270
501334,Company_121,2024-01-03,2024-03-02,2024-06-30,13009,9696,3313
501335,Company_121,2022-11-29,2023-01-12,2023-01-25,14274,12782,1492
501336,Company_121,2023-02-12,2023-03-08,2023-04-04,5949,2191,3758
501337,Company_121,2022-08-16,2022-09-20,2022-11-25,19402,4083,15319
501338,Company_121,2021-04-03,2021-05-08,2021-06-17,6235,5801,434
501339,Company_121,2020-04-19,2020-07-22,2020-10-27,3443,440,3003
501340,Company_121,2022-07-30,2022-09-01,2023-01-20,19930,9375,10555
501341,Company_121,2021-04-22,2021-08-06,2021-11-29,22994,4181,18813
501342,Company_121,2023-12-15,2024-03-25,2024-06-23,16389,14715,1674
501343,Company_121,2020-04-17,2020-06-24,2020-10-07,22358,6162,16196
501344,Company_121,2022-06-28,2022-07-22,2022-10-06,8187,6526,1661
501345,Company_121,2020-07-02,2020-10-21,2021-04-20,11342,1089,10253
501346,Company_121,2022-02-19,2022-03-24,2022-08-07,16159,14371,1788
501347,Company_122,2022-09-03,2022-10-24,2022-10-27,1685,1173,512
501348,Company_122,2021-12-28,2022-04-13,2022-09-28,3594,2824,770
501349,Company_122,2020-04-12,2020-07-23,2021-01-06,15096,2789,12307
501350,Company_122,2023-09-17,2023-12-29,2024-04-20,8201,2702,5499
501351,Company_122,2021-07-14,2021-09-04,2022-03-17,16846,9038,7808
501352,Company_122,2022-05-12,2022-07-26,2022-10-10,6391,2388,4003
501353,Company_122,2021-02-09,2021-03-24,2021-08-16,23320,16500,6820
501354,Company_122,2023-05-02,2023-05-29,2023-09-25,5156,151,5005
501355,Company_122,2020-12-30,2021-02-09,2021-03-24,9655,4183,5472
501356,Company_122,2022-01-19,2022-03-20,2022-06-12,21268,15250,6018
501357,Company_122,2023-07-23,2023-08-30,2024-03-13,17117,15643,1474
501358,Company_122,2020-05-15,2020-07-23,2020-10-28,14222,13420,802
501359,Company_122,2023-09-10,2023-12-05,2024-04-15,8544,3486,5058
501360,Company_123,2022-12-17,2023-02-03,2023-06-15,5713,3902,1811
501361,Company_123,2022-12-26,2023-03-29,2023-08-21,9652,1194,8458
501362,Company_124,2022-10-15,2022-11-27,2023-01-17,11295,3738,7557
501363,Company_124,2022-07-21,2022-08-17,2023-03-04,13840,7383,6457
501364,Company_124,2023-09-10,2023-10-31,2024-03-27,10408,236,10172
501365,Company_124,2020-02-16,2020-03-30,2020-10-03,2300,1863,437
501366,Company_124,2022-09-19,2022-12-30,2023-01-31,10371,81,10290
501367,Company_124,2023-04-18,2023-06-17,2023-08-19,5370,4273,1097
501368,Company_124,2022-11-12,2023-02-25,2023-09-04,19353,6761,12592
501369,Company_124,2021-06-06,2021-08-22,2021-10-28,24587,4498,20089
501370,Company_124,2023-08-30,2023-09-12,2023-11-12,9607,9371,236
501371,Company_124,2020-06-01,2020-07-08,2021-01-02,16969,5553,11416
501372,Company_124,2024-02-05,2024-02-18,2024-02-20,20288,13630,6658
501373,Company_124,2022-10-26,2022-11-09,2022-12-04,2997,397,2600
501374,Company_124,2022-10-15,2022-12-22,2023-01-20,10714,509,10205
501375,Company_124,2021-04-21,2021-07-10,2021-12-11,9257,5316,3941
501376,Company_124,2022-06-06,2022-07-15,2022-11-22,16992,2232,14760
501377,Company_125,2021-07-04,2021-08-22,2022-01-21,20235,18137,2098
501378,Company_125,2021-10-19,2021-11-19,2022-02-23,15610,2454,13156
501379,Company_125,2023-01-27,2023-05-15,2023-05-26,22840,5032,17808
501380,Company_125,2020-06-09,2020-07-07,2020-10-28,9907,89,9818
501381,Company_125,2023-10-23,2023-12-23,2024-01-17,3192,2165,1027
501382,Company_125,2022-03-15,2022-05-22,2022-09-20,10535,5607,4928
501383,Company_125,2022-08-13,2022-12-09,2023-06-07,21737,3994,17743
501384,Company_125,2020-04-18,2020-06-13,2020-11-10,5757,4533,1224
501385,Company_125,2023-07-18,2023-10-23,2024-04-06,18771,10771,8000
501386,Company_125,2021-01-09,2021-05-01,2021-07-20,4551,1186,3365
501387,Company_125,2020-07-15,2020-08-06,2021-01-05,6050,5743,307
501388,Company_125,2021-05-16,2021-06-16,2021-09-17,880,360,520
501389,Company_126,2021-05-02,2021-07-12,2021-10-13,19578,14157,5421
501390,Company_126,2022-04-29,2022-08-17,2022-10-30,8668,1387,7281
501391,Company_126,2022-04-22,2022-07-06,2022-09-29,21332,15512,5820
501392,Company_126,2023-04-04,2023-07-19,2023-10-04,14799,2721,12078
501393,Company_126,2023-10-20,2023-11-02,2024-04-01,3914,3011,903
501394,Company_126,2023-05-04,2023-05-18,2023-12-01,24613,1521,23092
501395,Company_126,2022-11-23,2023-03-12,2023-03-19,4182,1691,2491
501396,Company_126,2021-11-10,2022-02-02,2022-06-07,15427,3620,11807
501397,Company_126,2021-08-12,2021-11-09,2022-02-25,14957,7680,7277
501398,Company_126,2024-01-22,2024-02-27,2024-06-29,9397,4144,5253
501399,Company_126,2022-10-11,2022-12-01,2023-03-23,19986,11241,8745
501400,Company_126,2023-10-30,2024-01-27,2024-05-12,23476,688,22788
501401,Company_126,2021-10-30,2022-01-08,2022-03-21,6982,5651,1331
501402,Company_126,2020-04-18,2020-08-13,2020-08-13,22250,5149,17101
501403,Company_126,2020-09-04,2020-10-18,2021-04-03,16801,10936,5865
501404,Company_126,2021-07-28,2021-09-02,2021-12-25,13340,12067,1273
501405,Company_127,2021-10-07,2021-12-29,2022-02-28,13767,6566,7201
501406,Company_127,2020-07-02,2020-07-21,2020-12-09,10804,2466,8338
501407,Company_127,2024-01-12,2024-01-29,2024-08-09,18668,3247,15421
501408,Company_127,2023-03-18,2023-05-03,2023-09-20,11916,8705,3211
501409,Company_127,2020-10-02,2020-12-11,2021-06-26,9507,7559,1948
501410,Company_127,2021-08-30,2021-09-14,2021-09-14,4191,173,4018
501411,Company_127,2021-09-18,2021-11-08,2022-05-15,15467,3634,11833
501412,Company_127,2020-03-01,2020-06-24,2020-11-11,6936,2724,4212
501413,Company_127,2023-12-05,2023-12-24,2024-06-12,14934,12152,2782
501414,Company_127,2020-04-26,2020-06-26,2020-07-21,24836,5161,19675
501415,Company_127,2023-08-20,2023-11-27,2024-03-01,20469,3979,16490
501416,Company_127,2021-05-21,2021-09-11,2022-02-04,16009,2639,13370
501417,Company_127,2021-09-05,2021-11-23,2022-04-20,20725,6631,14094
501418,Company_127,2023-11-26,2023-12-21,2024-06-27,16051,11948,4103
501419,Company_127,2023-11-03,2024-01-09,2024-01-30,3446,591,2855
501420,Company_127,2022-03-02,2022-04-08,2022-09-22,23068,20147,2921
501421,Company_128,2020-01-14,2020-01-30,2020-06-23,24498,11641,12857
501422,Company_128,2021-02-24,2021-05-26,2021-11-23,18668,14816,3852
501423,Company_128,2022-02-11,2022-05-15,2022-07-20,12474,10546,1928
501424,Company_128,2022-09-16,2023-01-01,2023-01-01,6786,4817,1969
501425,Company_128,2021-02-19,2021-03-14,2021-08-17,4901,326,4575
501426,Company_128,2022-11-17,2022-12-11,2022-12-24,3434,1807,1627
501427,Company_128,2024-01-16,2024-05-02,2024-07-17,4840,1100,3740
501428,Company_128,2023-06-21,2023-09-26,2024-02-29,12713,9577,3136
501429,Company_128,2024-01-04,2024-03-20,2024-03-22,21775,1920,19855
501430,Company_128,2021-06-16,2021-06-30,2021-09-29,1773,1338,435
501431,Company_129,2022-02-24,2022-03-25,2022-06-10,11904,768,11136
501432,Company_129,2021-07-15,2021-08-12,2022-01-13,10851,9462,1389
501433,Company_129,2022-07-01,2022-10-16,2023-03-30,16621,13095,3526
501434,Company_129,2023-04-10,2023-05-29,2023-10-04,14788,754,14034
501435,Company_129,2021-10-12,2022-01-11,2022-03-21,22026,15993,6033
501436,Company_129,2023-01-08,2023-02-11,2023-05-12,23924,22175,1749
501437,Company_129,2023-05-17,2023-07-21,2023-12-12,8088,666,7422
501438,Company_129,2022-05-25,2022-09-09,2022-11-08,24484,20041,4443
501439,Company_129,2023-02-14,2023-06-09,2023-07-09,16954,3200,13754
501440,Company_130,2020-10-22,2020-11-15,2021-02-19,3375,1447,1928
501441,Company_130,2020-04-04,2020-05-14,2020-09-14,24532,7262,17270
501442,Company_130,2020-12-17,2021-03-07,2021-04-05,13271,8501,4770
501443,Company_130,2022-09-24,2022-10-13,2023-02-22,15291,6178,9113
501444,Company_130,2021-11-28,2022-01-21,2022-02-20,21833,14738,7095
501445,Company_130,2020-05-01,2020-08-06,2021-01-09,2760,827,1933
501446,Company_130,2022-01-13,2022-04-03,2022-05-14,6003,1405,4598
501447,Company_130,2023-11-16,2024-02-02,2024-05-21,16149,6812,9337
501448,Company_130,2024-01-01,2024-03-12,2024-07-01,17087,657,16430
501449,Company_130,2020-06-28,2020-08-13,2020-10-13,12592,5508,7084
501450,Company_130,2021-04-09,2021-07-05,2021-09-21,19578,7761,11817
501451,Company_130,2021-08-04,2021-11-29,2022-03-26,8610,4038,4572
501452,Company_130,2022-09-10,2022-11-01,2023-05-01,5684,2192,3492
501453,Company_131,2021-05-17,2021-07-30,2021-12-07,12867,3759,9108
501454,Company_131,2023-09-19,2023-11-07,2023-12-19,3156,769,2387
501455,Company_132,2023-11-23,2024-01-02,2024-07-05,12938,5686,7252
501456,Company_132,2020-02-29,2020-03-27,2020-04-26,3241,1299,1942
501457,Company_132,2023-12-06,2024-04-03,2024-08-20,1081,666,415
501458,Company_132,2020-12-12,2021-02-04,2021-06-29,14799,3074,11725
501459,Company_132,2020-12-17,2021-02-13,2021-08-03,3938,88,3850
501460,Company_132,2020-07-22,2020-09-23,2020-11-07,19890,6052,13838
501461,Company_132,2023-10-18,2023-12-13,2023-12-27,6606,1673,4933
501462,Company_132,2023-08-22,2023-09-27,2024-03-25,2381,920,1461
501463,Company_132,2023-08-24,2023-10-27,2024-01-12,21737,142,21595
501464,Company_132,2023-09-17,2023-10-15,2024-03-21,10021,5009,5012
501465,Company_132,2022-04-27,2022-07-11,2022-11-11,8583,5337,3246
501466,Company_133,2022-03-19,2022-07-14,2022-12-04,12873,7209,5664
501467,Company_133,2020-03-14,2020-06-23,2020-08-13,7508,3244,4264
501468,Company_133,2023-12-30,2024-01-23,2024-07-20,19838,4653,15185
501469,Company_133,2022-10-25,2023-01-10,2023-03-05,7699,2548,5151
501470,Company_133,2022-06-29,2022-09-28,2023-02-04,4926,2061,2865
501471,Company_133,2020-02-08,2020-03-12,2020-04-13,18777,6161,12616
501472,Company_133,2020-04-09,2020-05-31,2020-12-04,5129,4761,368
501473,Company_133,2023-04-24,2023-06-19,2023-08-06,15937,5063,10874
501474,Company_133,2023-12-07,2024-02-23,2024-07-05,16319,10759,5560
501475,Company_133,2023-04-26,2023-05-11,2023-10-25,1270,696,574
501476,Company_133,2023-04-19,2023-07-24,2024-01-12,24741,824,23917
501477,Company_134,2023-06-13,2023-08-13,2023-11-08,7117,4193,2924
501478,Company_134,2022-02-24,2022-05-09,2022-05-23,24230,1117,23113
501479,Company_134,2020-05-23,2020-07-02,2020-09-06,5087,3999,1088
501480,Company_135,2021-12-25,2022-02-19,2022-02-22,5186,4256,930
501481,Company_135,2021-08-12,2021-10-01,2022-02-09,5345,5285,60
501482,Company_135,2023-02-06,2023-05-13,2023-09-24,17294,822,16472
501483,Company_135,2023-09-15,2023-12-25,2024-07-11,6596,3850,2746
501484,Company_135,2023-08-13,2023-09-23,2023-09-25,16284,2030,14254
501485,Company_136,2022-08-16,2022-12-12,2023-06-07,21612,8670,12942
501486,Company_136,2024-01-06,2024-02-07,2024-04-29,16156,9237,6919
501487,Company_136,2023-05-17,2023-07-04,2023-12-12,22794,21978,816
501488,Company_136,2023-10-05,2024-01-25,2024-07-11,7768,3859,3909
501489,Company_137,2023-06-25,2023-10-14,2023-12-09,14435,8113,6322
501490,Company_137,2021-03-26,2021-07-23,2021-12-22,1207,1148,59
501491,Company_137,2021-02-26,2021-05-27,2021-07-28,17815,1246,16569
501492,Company_137,2022-11-27,2022-12-26,2023-02-02,7703,2168,5535
501493,Company_137,2020-01-21,2020-02-15,2020-04-18,14456,3153,11303
501494,Company_137,2020-05-11,2020-08-02,2021-01-15,24430,16249,8181
501495,Company_137,2020-02-20,2020-04-09,2020-10-21,11097,7437,3660
501496,Company_137,2023-07-06,2023-10-07,2024-04-21,22513,22253,260
501497,Company_137,2023-08-17,2023-11-15,2024-01-16,7647,357,7290
501498,Company_137,2021-05-17,2021-08-06,2021-08-11,24698,8068,16630
501499,Company_137,2021-02-28,2021-03-15,2021-04-19,15544,8991,6553
501500,Company_137,2023-04-30,2023-07-19,2023-08-25,7054,4503,2551
501501,Company_137,2023-09-20,2023-12-04,2024-05-08,2176,1138,1038
501502,Company_137,2023-02-01,2023-03-19,2023-06-09,22999,18414,4585
501503,Company_137,2023-05-21,2023-07-18,2023-08-26,16301,7129,9172
501504,Company_138,2021-04-08,2021-07-14,2021-08-27,5953,5393,560
501505,Company_138,2020-02-17,2020-06-15,2020-07-14,21595,20444,1151
501506,Company_139,2023-06-01,2023-09-01,2024-01-16,8617,7094,1523
501507,Company_139,2021-01-21,2021-02-15,2021-04-08,19017,10993,8024
501508,Company_140,2023-10-05,2023-12-20,2024-01-28,17605,7144,10461
501509,Company_140,2022-08-15,2022-11-30,2023-03-26,16061,534,15527
501510,Company_140,2021-06-24,2021-09-13,2021-11-25,15453,5321,10132
501511,Company_140,2023-04-13,2023-04-27,2023-06-05,20757,6122,14635
501512,Company_140,2023-09-15,2023-11-17,2024-02-02,1173,320,853
501513,Company_140,2023-05-06,2023-07-09,2023-08-23,21584,15203,6381
501514,Company_140,2022-12-20,2023-03-30,2023-04-20,22671,14179,8492
501515,Company_140,2020-08-25,2020-10-23,2021-04-09,15802,2483,13319
501516,Company_140,2022-11-25,2023-03-08,2023-04-14,22323,1899,20424
501517,Company_141,2021-12-23,2022-03-25,2022-07-15,14462,2516,11946
501518,Company_141,2022-03-09,2022-05-01,2022-05-02,16511,817,15694
501519,Company_141,2022-03-17,2022-04-06,2022-10-10,8473,6690,1783
501520,Company_141,2020-01-28,2020-05-21,2020-09-19,7045,3595,3450
501521,Company_141,2023-08-04,2023-08-26,2024-02-09,24109,20694,3415
501522,Company_141,2023-10-05,2023-11-23,2024-04-20,11502,10485,1017
501523,Company_141,2023-01-18,2023-04-20,2023-10-29,3414,2255,1159
501524,Company_141,2022-12-30,2023-01-19,2023-02-27,8702,4149,4553
501525,Company_141,2021-10-02,2022-01-11,2022-02-17,9182,6597,2585
501526,Company_141,2021-06-17,2021-09-03,2021-12-26,22200,9344,12856
501527,Company_141,2023-04-30,2023-08-17,2023-11-08,11441,10127,1314
501528,Company_141,2023-12-05,2024-03-09,2024-05-17,22170,5489,16681
501529,Company_141,2023-03-16,2023-06-08,2023-10-19,6405,584,5821
501530,Company_141,2023-12-26,2024-02-11,2024-08-05,2122,1987,135
501531,Company_141,2020-10-07,2020-12-05,2021-01-22,7570,1587,5983
501532,Company_141,2023-06-01,2023-06-30,2023-07-30,23394,16587,6807
501533,Company_142,2020-11-12,2020-11-29,2021-02-01,4673,2881,1792
501534,Company_142,2021-02-25,2021-04-15,2021-08-15,1984,1258,726
501535,Company_142,2021-12-21,2022-01-06,2022-02-24,14023,7717,6306
501536,Company_142,2022-11-13,2023-01-07,2023-06-23,24886,18775,6111
501537,Company_142,2020-04-08,2020-06-25,2020-09-22,2472,928,1544
501538,Company_142,2021-11-05,2022-02-10,2022-03-29,8435,5065,3370
501539,Company_142,2022-04-17,2022-08-10,2022-10-18,17646,3665,13981
501540,Company_142,2022-12-25,2023-01-11,2023-07-11,2602,1498,1104
501541,Company_142,2023-01-05,2023-01-30,2023-03-26,13395,2583,10812
501542,Company_142,2022-05-12,2022-08-21,2022-11-30,23719,6589,17130
501543,Company_142,2023-07-27,2023-11-18,2024-01-08,10612,200,10412
501544,Company_142,2020-03-27,2020-07-03,2020-11-06,12809,267,12542
501545,Company_142,2020-04-01,2020-04-14,2020-08-08,17547,14767,2780
501546,Company_142,2022-05-22,2022-07-06,2022-10-02,10853,2794,8059
501547,Company_142,2023-12-21,2024-02-13,2024-06-08,3947,494,3453
501548,Company_142,2021-08-31,2021-10-22,2022-03-09,17300,12106,5194
501549,Company_142,2023-05-11,2023-07-03,2023-12-07,14705,10255,4450
501550,Company_142,2023-12-05,2023-12-22,2024-01-28,19868,11910,7958
501551,Company_142,2023-04-18,2023-06-14,2023-07-21,17233,8190,9043
501552,Company_143,2022-09-19,2022-12-17,2023-07-03,20585,4127,16458
501553,Company_143,2021-11-28,2021-12-28,2022-03-05,8688,2758,5930
501554,Company_143,2020-11-24,2021-01-07,2021-06-17,9053,2646,6407
501555,Company_144,2023-03-17,2023-05-09,2023-05-28,21037,7792,13245
501556,Company_144,2021-01-29,2021-04-21,2021-08-17,11821,7723,4098
501557,Company_144,2022-08-04,2022-08-25,2023-01-05,7324,7198,126
501558,Company_144,2020-07-14,2020-08-01,2021-01-18,13479,5969,7510
501559,Company_144,2022-06-22,2022-07-30,2022-10-20,16591,16059,532
501560,Company_144,2021-02-02,2021-03-30,2021-06-24,13566,3057,10509
501561,Company_144,2020-02-20,2020-03-04,2020-07-30,13365,8444,4921
501562,Company_144,2020-01-26,2020-05-24,2020-07-31,6732,2964,3768
501563,Company_144,2020-12-10,2021-02-27,2021-04-10,17763,16493,1270
501564,Company_144,2021-07-18,2021-09-06,2021-12-19,8091,4411,3680
501565,Company_144,2020-05-27,2020-06-27,2020-09-09,13689,13091,598
501566,Company_144,2020-11-24,2021-01-24,2021-02-24,1412,827,585
501567,Company_144,2021-10-29,2022-01-04,2022-06-25,6866,6678,188
501568,Company_144,2020-07-03,2020-07-21,2020-08-24,21914,19335,2579
501569,Company_145,2021-06-10,2021-06-23,2021-12-07,8830,1573,7257
501570,Company_145,2022-02-20,2022-06-02,2022-12-15,6069,4468,1601
501571,Company_145,2021-04-14,2021-08-10,2022-01-15,10002,4911,5091
501572,Company_145,2022-03-15,2022-05-11,2022-10-29,9021,1111,7910
501573,Company_145,2024-01-12,2024-03-23,2024-09-20,2655,2190,465
501574,Company_145,2024-01-28,2024-05-21,2024-11-17,3569,1672,1897
501575,Company_145,2023-04-03,2023-05-01,2023-06-16,1823,286,1537
501576,Company_145,2020-08-01,2020-08-26,2020-12-25,10380,9269,1111
501577,Company_145,2022-07-11,2022-10-01,2022-12-29,5668,3358,2310
501578,Company_145,2020-11-19,2021-02-07,2021-08-06,6845,1655,5190
501579,Company_145,2022-04-11,2022-04-27,2022-08-05,11894,764,11130
501580,Company_145,2020-02-03,2020-03-03,2020-04-16,21696,14317,7379
501581,Company_145,2020-04-30,2020-07-02,2020-11-08,22931,9128,13803
501582,Company_145,2023-08-14,2023-09-11,2023-11-18,20723,2112,18611
501583,Company_145,2021-06-22,2021-07-02,2021-12-22,1839,857,982
501584,Company_145,2020-06-23,2020-09-14,2021-02-21,13066,10833,2233
501585,Company_145,2023-01-21,2023-04-23,2023-06-25,11564,9912,1652
501586,Company_145,2023-01-01,2023-02-06,2023-07-08,7244,3488,3756
501587,Company_146,2023-03-14,2023-04-21,2023-10-25,22866,8510,14356
501588,Company_146,2023-08-08,2023-10-01,2023-11-03,7170,1890,5280
501589,Company_146,2021-07-28,2021-09-11,2021-09-15,3867,880,2987
501590,Company_146,2021-12-28,2022-03-15,2022-04-16,12065,11854,211
501591,Company_146,2023-04-30,2023-06-19,2023-12-19,20963,9613,11350
501592,Company_146,2020-06-30,2020-07-12,2020-08-26,14873,7470,7403
501593,Company_147,2022-09-25,2022-11-13,2023-04-01,5141,3762,1379
501594,Company_147,2023-07-25,2023-08-07,2023-11-21,11474,3100,8374
501595,Company_148,2022-01-27,2022-03-15,2022-03-31,9986,7289,2697
501596,Company_148,2021-09-12,2021-12-21,2021-12-22,24320,6237,18083
501597,Company_148,2022-03-16,2022-06-10,2022-07-12,23712,10064,13648
501598,Company_149,2023-06-20,2023-07-27,2024-01-29,23049,14440,8609
501599,Company_149,2022-07-14,2022-08-17,2022-11-07,17251,8079,9172
501600,Company_149,2021-04-10,2021-05-28,2021-06-11,8293,8058,235
501601,Company_149,2020-09-17,2020-11-22,2020-12-31,18638,7176,11462
501602,Company_149,2021-08-21,2021-09-12,2021-12-15,4008,2283,1725
501603,Company_149,2023-09-20,2024-01-03,2024-03-21,8527,6354,2173
501604,Company_149,2022-08-17,2022-08-27,2022-12-02,17667,1821,15846
501605,Company_149,2020-08-23,2020-09-10,2020-10-22,1881,1094,787
501606,Company_149,2021-01-29,2021-05-15,2021-05-16,23018,7142,15876
501607,Company_149,2020-07-18,2020-11-10,2020-12-07,5682,5377,305
501608,Company_150,2021-03-07,2021-06-26,2021-10-11,2854,1929,925
501609,Company_150,2021-12-04,2022-04-02,2022-04-04,5036,994,4042
501610,Company_150,2023-06-06,2023-07-20,2024-01-13,19309,2883,16426
501611,Company_150,2022-04-03,2022-07-17,2022-11-24,15840,291,15549
501612,Company_150,2022-10-02,2022-12-02,2023-03-11,9820,7637,2183
501613,Company_150,2020-08-19,2020-11-12,2021-01-16,12842,1159,11683
501614,Company_150,2023-04-13,2023-05-27,2023-11-02,13927,9821,4106
501615,Company_150,2023-10-24,2023-11-08,2024-02-24,16177,8451,7726
501616,Company_150,2022-02-25,2022-05-17,2022-10-07,22311,11870,10441
501617,Company_151,2020-12-01,2021-01-04,2021-04-12,2718,2253,465
501618,Company_151,2020-08-11,2020-10-29,2021-02-18,7322,7298,24
501619,Company_151,2021-08-28,2021-12-23,2022-07-04,24529,19988,4541
501620,Company_151,2022-10-11,2022-10-22,2022-11-28,21087,6403,14684
501621,Company_151,2020-01-02,2020-01-14,2020-07-01,16306,4346,11960
501622,Company_151,2021-06-16,2021-08-20,2021-08-21,24830,20947,3883
501623,Company_151,2021-08-21,2021-11-28,2022-06-10,10337,5061,5276
501624,Company_151,2021-01-11,2021-02-01,2021-08-18,991,538,453
501625,Company_151,2023-12-28,2024-01-31,2024-08-06,5054,3561,1493
501626,Company_151,2020-11-23,2020-12-28,2021-03-17,13777,8452,5325
501627,Company_151,2021-12-15,2022-03-11,2022-07-11,5767,933,4834
501628,Company_151,2023-09-11,2023-12-30,2024-02-12,24005,6417,17588
501629,Company_152,2020-04-22,2020-08-08,2020-08-18,16605,10768,5837
501630,Company_152,2021-09-25,2021-12-01,2022-06-08,7889,7719,170
501631,Company_152,2021-06-02,2021-07-01,2021-10-21,23125,3188,19937
501632,Company_152,2021-05-06,2021-07-19,2021-10-12,13888,460,13428
501633,Company_152,2020-06-27,2020-10-03,2021-01-08,7329,7121,208
501634,Company_152,2023-10-15,2024-01-16,2024-06-21,15223,11565,3658
501635,Company_153,2020-08-11,2020-11-17,2021-01-24,9111,1107,8004
501636,Company_153,2023-05-26,2023-07-19,2023-09-27,24052,293,23759
501637,Company_153,2023-11-07,2024-03-02,2024-06-12,1682,1500,182
501638,Company_154,2020-07-13,2020-09-02,2020-10-03,22033,1370,20663
501639,Company_154,2021-04-12,2021-07-30,2021-10-18,12687,6150,6537
501640,Company_154,2023-06-04,2023-07-22,2023-10-01,13049,600,12449
501641,Company_154,2021-11-21,2021-12-24,2022-04-27,18685,12497,6188
501642,Company_154,2023-02-11,2023-04-01,2023-07-16,12217,8086,4131
501643,Company_154,2023-06-20,2023-08-01,2024-01-20,13826,3406,10420
501644,Company_154,2020-04-15,2020-05-23,2020-11-27,16942,8624,8318
501645,Company_154,2022-09-07,2022-11-29,2023-01-10,24998,7233,17765
501646,Company_154,2023-02-24,2023-03-18,2023-08-17,4410,2643,1767
501647,Company_154,2022-02-05,2022-04-01,2022-09-15,13893,5345,8548
501648,Company_154,2024-01-07,2024-04-05,2024-07-21,21307,20641,666
501649,Company_154,2020-10-16,2020-12-06,2021-06-10,20577,19220,1357
501650,Company_154,2021-05-21,2021-08-06,2022-02-15,5353,3751,1602
501651,Company_155,2020-12-24,2021-01-16,2021-07-01,12583,5357,7226
501652,Company_155,2023-08-17,2023-09-04,2024-01-07,1065,94,971
501653,Company_155,2021-07-23,2021-11-09,2022-01-07,6506,4381,2125
501654,Company_155,2023-01-26,2023-03-20,2023-03-21,23775,9517,14258
501655,Company_155,2022-01-02,2022-02-03,2022-08-12,11719,3326,8393
501656,Company_155,2022-05-08,2022-06-09,2022-10-03,22060,8465,13595
501657,Company_155,2020-08-22,2020-10-31,2020-12-22,2710,385,2325
501658,Company_155,2021-09-23,2021-11-16,2022-05-16,22988,12136,10852
501659,Company_155,2022-09-14,2022-10-15,2023-03-20,17213,15899,1314
501660,Company_155,2021-11-18,2022-01-03,2022-02-17,21834,11383,10451
501661,Company_156,2021-08-26,2021-11-26,2022-01-29,8241,7476,765
501662,Company_156,2023-02-04,2023-03-14,2023-06-29,12068,4980,7088
501663,Company_156,2020-04-14,2020-05-17,2020-09-06,12569,3847,8722
501664,Company_156,2021-01-04,2021-02-13,2021-08-13,6908,1705,5203
501665,Company_156,2023-11-10,2024-02-22,2024-09-08,22225,752,21473
501666,Company_156,2020-04-17,2020-05-22,2020-08-01,20416,11710,8706
501667,Company_156,2021-10-30,2021-12-15,2022-04-19,21481,5915,15566
501668,Company_156,2022-12-30,2023-04-04,2023-09-05,22688,2527,20161
501669,Company_156,2022-05-15,2022-09-04,2022-11-14,14221,11624,2597
501670,Company_156,2023-05-08,2023-07-11,2023-08-09,1643,1474,169
501671,Company_156,2021-01-31,2021-05-05,2021-06-12,20261,2559,17702
501672,Company_156,2022-07-13,2022-08-05,2022-11-02,15509,9949,5560
501673,Company_156,2023-12-03,2023-12-29,2024-03-09,8714,5548,3166
501674,Company_156,2022-01-26,2022-04-27,2022-06-02,7020,4292,2728
501675,Company_156,2020-04-08,2020-06-12,2020-06-26,12756,5091,7665
501676,Company_156,2020-06-18,2020-08-03,2020-08-22,5376,205,5171
501677,Company_156,2023-07-06,2023-09-03,2023-11-10,4134,24,4110
501678,Company_156,2021-10-16,2021-10-31,2021-12-13,6069,5556,513
501679,Company_156,2022-03-20,2022-06-26,2022-12-12,20323,5962,14361
501680,Company_157,2023-08-27,2023-12-24,2024-02-16,24658,4587,20071
501681,Company_157,2020-03-11,2020-03-31,2020-05-27,15615,7160,8455
501682,Company_157,2020-04-13,2020-06-13,2020-10-21,18977,11045,7932
501683,Company_157,2020-02-17,2020-04-26,2020-08-19,8164,4177,3987
501684,Company_157,2022-07-08,2022-10-26,2022-11-03,10340,2758,7582
501685,Company_157,2022-11-23,2023-02-27,2023-03-20,17189,16225,964
501686,Company_157,2023-06-15,2023-08-28,2023-12-12,18539,13123,5416
501687,Company_157,2020-12-05,2021-02-12,2021-08-12,18536,14422,4114
501688,Company_157,2020-03-13,2020-06-11,2020-06-15,22697,13620,9077
501689,Company_157,2022-03-04,2022-03-26,2022-09-15,21571,6879,14692
501690,Company_157,2021-06-17,2021-10-11,2021-11-24,13590,173,13417
501691,Company_157,2020-09-12,2020-09-30,2021-03-16,4061,2914,1147
501692,Company_157,2021-07-02,2021-07-12,2021-08-06,15905,5404,10501
501693,Company_157,2020-05-24,2020-06-10,2020-07-24,21723,4568,17155
501694,Company_157,2020-04-13,2020-07-29,2020-12-21,22163,19500,2663
501695,Company_158,2020-07-28,2020-08-27,2020-09-29,959,683,276
501696,Company_158,2023-11-27,2024-02-07,2024-08-16,3977,2702,1275
501697,Company_158,2023-06-10,2023-08-20,2023-12-19,18092,15168,2924
501698,Company_158,2023-07-16,2023-10-28,2024-04-23,1124,14,1110
501699,Company_158,2022-02-23,2022-06-07,2022-10-23,20018,13382,6636
501700,Company_158,2023-06-11,2023-08-18,2023-10-28,14448,8969,5479
501701,Company_158,2022-06-19,2022-08-29,2022-09-29,21539,12506,9033
501702,Company_158,2023-10-15,2024-01-01,2024-05-12,21624,18185,3439
501703,Company_158,2021-09-14,2021-11-15,2021-12-21,19693,19258,435
501704,Company_158,2020-03-05,2020-04-23,2020-08-03,23982,20695,3287
501705,Company_158,2022-09-27,2022-11-01,2023-02-27,24491,15437,9054
501706,Company_159,2021-09-02,2021-09-30,2021-12-24,14757,8871,5886
501707,Company_159,2021-11-11,2022-01-19,2022-02-18,17273,709,16564
501708,Company_159,2024-01-01,2024-02-03,2024-06-01,23131,4049,19082
501709,Company_159,2021-07-20,2021-09-19,2022-01-31,21184,19109,2075
501710,Company_159,2022-10-08,2022-11-18,2023-01-01,4537,900,3637
501711,Company_159,2020-03-13,2020-05-06,2020-09-15,20277,7028,13249
501712,Company_159,2020-02-04,2020-02-14,2020-07-20,4087,2802,1285
501713,Company_159,2021-11-12,2022-01-31,2022-03-15,24585,6041,18544
501714,Company_159,2020-09-16,2020-11-18,2021-04-11,23005,1271,21734
501715,Company_159,2023-01-12,2023-02-18,2023-05-30,14153,2798,11355
501716,Company_159,2021-12-18,2022-01-07,2022-02-05,5604,2366,3238
501717,Company_159,2020-03-09,2020-05-25,2020-08-27,20839,4152,16687
501718,Company_160,2022-12-28,2023-01-16,2023-03-23,22054,1879,20175
501719,Company_160,2023-08-29,2023-10-22,2023-11-03,20915,6278,14637
501720,Company_160,2022-07-30,2022-09-17,2023-03-09,2179,2091,88
501721,Company_160,2023-04-09,2023-06-29,2023-08-01,3670,1771,1899
501722,Company_160,2022-10-15,2023-02-10,2023-03-27,24860,20582,4278
501723,Company_160,2022-07-09,2022-09-29,2023-01-28,14772,271,14501
501724,Company_160,2020-05-24,2020-06-22,2020-10-25,18564,6230,12334
501725,Company_160,2021-07-21,2021-09-26,2022-01-21,5947,3106,2841
501726,Company_160,2020-07-13,2020-10-24,2020-12-28,23232,7035,16197
501727,Company_160,2021-06-23,2021-07-12,2022-01-16,8980,2754,6226
501728,Company_160,2021-04-19,2021-07-26,2022-02-01,1067,962,105
501729,Company_160,2022-02-06,2022-04-27,2022-08-23,3299,2665,634
501730,Company_160,2021-10-22,2021-11-03,2022-04-12,8455,3264,5191
501731,Company_160,2023-05-29,2023-07-30,2023-07-31,19014,12942,6072
501732,Company_160,2023-11-06,2024-02-06,2024-06-06,19566,12005,7561
501733,Company_160,2023-10-23,2023-12-18,2024-04-24,7616,1746,5870
501734,Company_160,2020-02-17,2020-05-23,2020-09-19,11262,5038,6224
501735,Company_161,2021-02-10,2021-03-06,2021-08-17,993,803,190
501736,Company_161,2021-12-10,2021-12-21,2022-03-12,3729,151,3578
501737,Company_161,2021-06-19,2021-08-10,2022-02-01,10173,2289,7884
501738,Company_161,2020-01-15,2020-05-06,2020-06-25,2556,1360,1196
501739,Company_161,2022-02-08,2022-04-24,2022-10-23,24669,5524,19145
501740,Company_161,2022-07-19,2022-11-06,2023-04-13,3055,2951,104
501741,Company_161,2020-05-23,2020-08-14,2020-09-04,17110,3220,13890
501742,Company_161,2022-11-03,2023-02-07,2023-02-15,16661,8001,8660
501743,Company_161,2020-04-19,2020-08-09,2020-10-05,17278,5682,11596
501744,Company_162,2023-09-26,2023-11-24,2023-12-27,10728,7858,2870
501745,Company_162,2020-01-05,2020-02-25,2020-02-29,24474,4088,20386
501746,Company_162,2022-12-12,2023-01-17,2023-03-01,22320,19620,2700
501747,Company_162,2021-02-23,2021-04-20,2021-06-15,21734,13797,7937
501748,Company_162,2020-04-18,2020-06-09,2020-12-14,16532,1243,15289
501749,Company_162,2020-11-18,2021-01-18,2021-04-14,10053,7460,2593
501750,Company_162,2021-01-26,2021-02-08,2021-07-24,3603,1127,2476
501751,Company_162,2023-10-08,2024-01-29,2024-08-09,20388,7729,12659
501752,Company_162,2022-05-17,2022-08-07,2023-01-03,14706,604,14102
501753,Company_162,2020-12-15,2021-01-24,2021-02-01,10491,8038,2453
501754,Company_162,2022-01-02,2022-03-24,2022-10-07,16711,14724,1987
501755,Company_162,2022-03-07,2022-05-31,2022-08-11,11901,6280,5621
501756,Company_162,2021-12-22,2022-01-02,2022-06-07,2384,2159,225
501757,Company_162,2024-01-27,2024-03-26,2024-06-08,24524,5078,19446
501758,Company_162,2021-01-18,2021-04-22,2021-04-30,22409,3904,18505
501759,Company_162,2022-04-22,2022-08-07,2022-10-14,11061,3434,7627
501760,Company_162,2023-01-01,2023-01-22,2023-03-22,12046,10773,1273
501761,Company_163,2021-05-09,2021-08-29,2021-12-08,6355,1247,5108
501762,Company_163,2020-11-03,2021-01-29,2021-06-04,7081,2087,4994
501763,Company_163,2020-01-12,2020-02-08,2020-05-09,10255,7279,2976
501764,Company_163,2021-11-15,2022-02-18,2022-06-04,21556,9107,12449
501765,Company_163,2023-11-22,2024-01-28,2024-05-16,10367,7132,3235
501766,Company_163,2020-05-07,2020-08-16,2020-11-04,7483,3704,3779
501767,Company_163,2021-07-23,2021-08-20,2021-11-09,13702,8354,5348
501768,Company_163,2023-10-24,2023-12-07,2024-01-20,6707,1939,4768
501769,Company_163,2023-03-28,2023-05-20,2023-09-25,14073,4257,9816
501770,Company_163,2023-05-18,2023-09-09,2024-02-27,22215,7103,15112
501771,Company_163,2020-03-03,2020-05-05,2020-07-26,1654,484,1170
501772,Company_163,2022-04-01,2022-05-09,2022-11-04,14693,5205,9488
501773,Company_163,2023-02-08,2023-05-19,2023-11-28,5375,4773,602
501774,Company_163,2021-08-21,2021-11-26,2022-01-04,21839,7598,14241
501775,Company_163,2020-04-02,2020-07-03,2020-10-03,10388,91,10297
501776,Company_163,2023-11-07,2024-01-17,2024-06-06,24014,17875,6139
501777,Company_163,2021-11-29,2022-02-26,2022-03-11,22994,7328,15666
501778,Company_163,2023-08-20,2023-09-08,2024-03-01,23677,17991,5686
501779,Company_163,2020-07-18,2020-09-05,2020-10-07,10571,9838,733
501780,Company_164,2021-06-08,2021-07-24,2021-10-16,18022,13605,4417
501781,Company_164,2022-01-15,2022-02-18,2022-03-17,3177,528,2649
501782,Company_164,2023-11-27,2024-01-13,2024-07-12,5414,3549,1865
501783,Company_164,2021-10-09,2022-01-20,2022-03-26,10116,482,9634
501784,Company_165,2020-04-10,2020-05-29,2020-06-11,19297,860,18437
501785,Company_165,2020-01-23,2020-05-20,2020-09-20,4822,1758,3064
501786,Company_165,2023-09-30,2023-11-19,2024-05-15,4276,4190,86
501787,Company_165,2022-01-28,2022-02-23,2022-03-11,20522,7520,13002
501788,Company_165,2022-05-30,2022-07-18,2022-07-25,14533,7904,6629
501789,Company_165,2022-12-30,2023-04-28,2023-08-02,4840,2245,2595
501790,Company_165,2021-07-05,2021-10-22,2021-11-11,2399,1249,1150
501791,Company_165,2022-05-10,2022-07-27,2023-02-11,3735,1392,2343
501792,Company_165,2023-06-27,2023-07-15,2024-01-03,9210,2608,6602
501793,Company_165,2023-04-11,2023-07-10,2024-01-23,18225,4473,13752
501794,Company_165,2020-11-18,2021-01-10,2021-03-07,11587,6555,5032
501795,Company_165,2022-05-12,2022-07-14,2022-12-29,9325,7670,1655
501796,Company_165,2020-09-04,2020-11-16,2021-05-31,17600,5372,12228
501797,Company_165,2021-03-21,2021-05-15,2021-05-26,7061,6220,841
501798,Company_165,2023-11-20,2024-03-12,2024-06-24,7329,5401,1928
501799,Company_165,2021-02-09,2021-04-29,2021-09-24,12930,7562,5368
501800,Company_165,2022-07-31,2022-08-15,2023-01-06,5315,566,4749
501801,Company_166,2020-07-19,2020-10-10,2021-02-14,9180,4780,4400
501802,Company_166,2021-09-02,2021-12-22,2022-02-26,837,485,352
501803,Company_166,2023-04-21,2023-06-12,2023-06-17,3550,2345,1205
501804,Company_167,2023-10-23,2023-12-04,2024-03-01,6790,2148,4642
501805,Company_167,2022-07-04,2022-10-01,2023-03-26,23161,13271,9890
501806,Company_167,2020-04-04,2020-04-23,2020-07-07,1862,1817,45
501807,Company_167,2021-09-10,2021-10-03,2021-11-19,21619,7492,14127
501808,Company_167,2023-07-02,2023-09-29,2023-12-04,6225,3240,2985
501809,Company_167,2023-09-23,2023-10-18,2024-05-02,20480,11337,9143
501810,Company_167,2020-06-28,2020-10-10,2021-03-17,22836,19003,3833
501811,Company_167,2021-05-02,2021-07-04,2021-07-09,9847,8659,1188
501812,Company_167,2023-05-04,2023-05-20,2023-09-24,17254,15036,2218
501813,Company_167,2022-01-22,2022-05-20,2022-05-24,2930,1245,1685
501814,Company_167,2020-09-15,2020-10-13,2021-01-05,16040,14314,1726
501815,Company_167,2021-08-27,2021-10-12,2021-12-31,12340,7477,4863
501816,Company_167,2021-01-21,2021-04-19,2021-07-01,11863,5399,6464
501817,Company_167,2020-11-14,2020-12-19,2021-02-02,5183,2162,3021
501818,Company_167,2020-08-16,2020-12-11,2021-01-28,20350,66,20284
501819,Company_167,2020-11-03,2021-02-08,2021-08-19,16690,12075,4615
501820,Company_168,2023-01-04,2023-04-29,2023-09-10,10672,7794,2878
501821,Company_168,2023-01-10,2023-04-09,2023-04-11,18149,9490,8659
501822,Company_168,2020-05-19,2020-08-27,2020-09-22,12121,3352,8769
501823,Company_168,2021-09-09,2021-11-09,2022-03-09,15316,7268,8048
501824,Company_169,2020-09-01,2020-11-11,2021-04-21,21339,9354,11985
501825,Company_169,2022-05-21,2022-07-07,2022-09-26,13970,5620,8350
501826,Company_169,2020-08-11,2020-12-01,2021-05-30,18309,10328,7981
501827,Company_169,2022-10-01,2023-01-04,2023-03-19,11369,5896,5473
501828,Company_169,2021-07-04,2021-10-13,2022-02-03,16358,293,16065
501829,Company_169,2023-09-03,2023-12-13,2024-03-12,5355,2518,2837
501830,Company_169,2024-01-22,2024-04-05,2024-06-21,4792,458,4334
501831,Company_169,2022-03-27,2022-06-08,2022-12-05,12328,2602,9726
501832,Company_170,2022-05-17,2022-06-14,2022-08-31,13633,3576,10057
501833,Company_170,2020-09-17,2020-12-06,2020-12-31,11393,2939,8454
501834,Company_170,2020-12-14,2020-12-30,2021-01-16,16062,1374,14688
501835,Company_170,2020-08-28,2020-11-08,2021-03-15,12297,1314,10983
501836,Company_170,2023-01-26,2023-05-05,2023-07-07,6287,1443,4844
501837,Company_170,2020-12-31,2021-03-20,2021-05-12,1795,524,1271
501838,Company_170,2022-01-30,2022-05-06,2022-06-26,24429,10082,14347
501839,Company_170,2023-12-20,2024-03-08,2024-06-25,22892,11002,11890
501840,Company_170,2021-06-08,2021-09-19,2021-12-07,7245,1860,5385
501841,Company_170,2021-07-18,2021-10-04,2021-11-29,16258,11553,4705
501842,Company_170,2023-06-23,2023-07-26,2023-12-14,10707,10292,415
501843,Company_170,2021-09-04,2021-10-21,2021-12-16,9465,7336,2129
501844,Company_170,2022-02-23,2022-04-15,2022-07-15,16710,13045,3665
501845,Company_170,2020-03-02,2020-04-26,2020-09-09,19335,17674,1661
501846,Company_170,2023-11-02,2024-02-23,2024-05-31,4170,2349,1821
501847,Company_170,2022-01-20,2022-03-22,2022-04-06,9722,3621,6101
501848,Company_171,2022-12-05,2022-12-29,2023-04-11,20982,16443,4539
501849,Company_171,2023-01-03,2023-02-28,2023-05-26,6881,2980,3901
501850,Company_172,2020-06-01,2020-09-04,2020-10-22,18431,1722,16709
501851,Company_172,2023-02-07,2023-05-02,2023-09-26,17424,14867,2557
501852,Company_172,2022-07-21,2022-09-08,2023-02-09,3459,202,3257
501853,Company_172,2023-04-03,2023-06-30,2023-10-06,18602,16936,1666
501854,Company_172,2022-09-02,2022-11-21,2022-12-24,2377,86,2291
501855,Company_172,2022-02-18,2022-06-09,2022-12-14,18442,9927,8515
501856,Company_172,2022-08-02,2022-10-02,2022-12-09,1266,1245,21
501857,Company_173,2020-11-30,2021-01-13,2021-07-01,19958,18309,1649
501858,Company_173,2022-07-30,2022-10-20,2022-10-22,16699,686,16013
501859,Company_173,2020-03-03,2020-06-24,2020-09-08,9616,3893,5723
501860,Company_173,2021-07-23,2021-08-16,2021-12-28,17128,2375,14753
501861,Company_173,2022-02-06,2022-05-11,2022-11-20,3967,3456,511
501862,Company_173,2020-12-15,2021-03-22,2021-08-11,22634,13024,9610
501863,Company_173,2021-08-14,2021-11-17,2022-04-28,24630,17035,7595
501864,Company_173,2021-06-13,2021-07-13,2021-11-21,2832,2424,408
501865,Company_173,2021-04-18,2021-04-28,2021-10-31,15594,7350,8244
501866,Company_173,2020-11-30,2021-01-26,2021-04-03,23928,9085,14843
501867,Company_173,2024-01-10,2024-04-23,2024-08-03,19008,17676,1332
501868,Company_173,2020-12-15,2021-03-13,2021-07-05,14448,2962,11486
501869,Company_173,2023-03-27,2023-06-26,2023-08-15,18845,12832,6013
501870,Company_173,2022-04-04,2022-05-19,2022-09-29,11070,10341,729
501871,Company_173,2022-10-22,2023-01-12,2023-05-09,9677,45,9632
501872,Company_174,2022-10-20,2022-12-08,2023-04-21,10302,5848,4454
501873,Company_174,2021-02-25,2021-05-07,2021-08-07,13406,7095,6311
501874,Company_174,2023-01-18,2023-04-30,2023-11-03,23751,9273,14478
501875,Company_174,2021-10-19,2022-01-09,2022-04-08,7663,3187,4476
501876,Company_175,2020-01-14,2020-03-29,2020-07-11,10999,4089,6910
501877,Company_175,2020-11-17,2021-01-12,2021-05-04,22977,14435,8542
501878,Company_175,2023-03-09,2023-05-27,2023-10-03,3601,2578,1023
501879,Company_175,2021-07-25,2021-10-10,2022-01-29,22609,3816,18793
501880,Company_175,2021-03-08,2021-03-30,2021-04-29,21788,5076,16712
501881,Company_175,2022-05-16,2022-07-16,2022-09-24,1585,89,1496
501882,Company_175,2022-10-01,2022-11-07,2023-03-13,17827,11743,6084
501883,Company_175,2022-03-29,2022-07-17,2022-11-08,15443,10384,5059
501884,Company_175,2020-02-05,2020-04-04,2020-08-28,17497,12119,5378
501885,Company_175,2022-04-01,2022-05-02,2022-09-25,20211,3281,16930
501886,Company_175,2021-04-19,2021-06-03,2021-07-22,17267,8167,9100
501887,Company_175,2021-07-24,2021-10-02,2021-10-12,14355,5397,8958
501888,Company_175,2021-12-08,2022-02-14,2022-06-08,17878,15737,2141
501889,Company_175,2021-12-10,2022-03-29,2022-09-02,2773,2684,89
501890,Company_175,2021-08-29,2021-09-08,2021-09-28,12415,6431,5984
501891,Company_175,2022-07-05,2022-08-15,2022-10-17,9567,6540,3027
501892,Company_175,2022-11-24,2022-12-09,2023-04-14,9698,5997,3701
501893,Company_176,2022-08-09,2022-10-10,2023-01-19,18454,9288,9166
501894,Company_176,2020-11-26,2021-02-08,2021-08-14,4411,3654,757
501895,Company_176,2024-01-24,2024-02-22,2024-07-22,13447,2254,11193
501896,Company_176,2023-06-24,2023-09-16,2024-03-31,12007,10346,1661
501897,Company_176,2022-02-10,2022-05-01,2022-09-26,17741,8376,9365
501898,Company_176,2020-07-02,2020-09-10,2021-03-04,4066,3324,742
501899,Company_176,2023-06-20,2023-09-23,2023-12-28,17859,10345,7514
501900,Company_176,2023-01-17,2023-02-27,2023-07-30,1915,1894,21
501901,Company_177,2022-05-23,2022-06-22,2022-11-21,21114,6177,14937
501902,Company_177,2023-03-24,2023-07-16,2023-10-06,12871,11984,887
501903,Company_177,2020-03-26,2020-04-11,2020-09-10,11566,11206,360
501904,Company_177,2023-12-22,2024-04-05,2024-09-09,11473,9771,1702
501905,Company_177,2023-12-15,2024-03-02,2024-09-13,8051,7798,253
501906,Company_177,2020-08-26,2020-11-19,2021-03-19,1042,26,1016
501907,Company_177,2021-03-28,2021-06-10,2021-09-30,12614,8356,4258
501908,Company_177,2023-10-18,2023-11-22,2024-04-22,18679,4350,14329
501909,Company_177,2023-10-11,2024-01-25,2024-05-21,24564,8348,16216
501910,Company_177,2021-09-17,2021-09-30,2021-10-02,9827,2835,6992
501911,Company_177,2021-05-30,2021-06-27,2021-07-24,2569,56,2513
501912,Company_177,2022-12-11,2023-01-10,2023-04-28,7835,6913,922
501913,Company_177,2023-01-18,2023-03-30,2023-10-05,8202,5427,2775
501914,Company_177,2021-08-15,2021-10-22,2022-01-25,1277,726,551
501915,Company_177,2020-08-18,2020-11-11,2020-12-29,10765,109,10656
501916,Company_177,2022-04-05,2022-05-14,2022-09-11,9499,4073,5426
501917,Company_177,2023-07-23,2023-10-23,2024-02-08,10859,9309,1550
501918,Company_178,2021-02-17,2021-04-08,2021-04-27,21393,2242,19151
501919,Company_178,2020-11-16,2021-03-07,2021-07-16,10432,3149,7283
501920,Company_178,2020-04-09,2020-05-07,2020-07-26,8596,1759,6837
501921,Company_178,2020-04-25,2020-05-31,2020-11-02,1870,545,1325
501922,Company_178,2021-04-28,2021-07-23,2021-10-01,14409,12129,2280
501923,Company_179,2021-12-17,2022-01-08,2022-06-11,19877,11917,7960
501924,Company_179,2023-11-29,2024-03-21,2024-09-08,1468,815,653
501925,Company_179,2020-12-15,2021-02-11,2021-05-28,22284,3183,19101
501926,Company_179,2021-01-07,2021-03-24,2021-09-07,20837,2585,18252
501927,Company_179,2022-03-13,2022-05-18,2022-11-11,23474,23348,126
501928,Company_179,2021-04-11,2021-08-05,2022-02-16,11236,6593,4643
501929,Company_179,2022-04-24,2022-07-28,2022-10-30,20357,7439,12918
501930,Company_179,2022-09-29,2023-01-13,2023-02-15,18603,18581,22
501931,Company_179,2022-01-03,2022-04-30,2022-10-14,20423,2167,18256
501932,Company_179,2021-04-17,2021-07-11,2022-01-17,17620,11108,6512
501933,Company_179,2020-04-06,2020-07-23,2020-10-08,8717,932,7785
501934,Company_179,2021-12-02,2022-02-10,2022-08-16,10347,4593,5754
501935,Company_179,2021-07-30,2021-10-13,2022-04-01,12613,1616,10997
501936,Company_179,2020-01-16,2020-04-19,2020-05-21,15511,6022,9489
501937,Company_180,2021-04-05,2021-04-20,2021-09-19,5705,2740,2965
501938,Company_180,2021-05-30,2021-08-08,2021-11-20,7780,749,7031
501939,Company_180,2020-03-31,2020-04-27,2020-10-06,20464,6918,13546
501940,Company_180,2020-08-27,2020-11-17,2021-03-13,22682,16440,6242
501941,Company_180,2020-06-14,2020-10-10,2020-11-09,6946,6692,254
501942,Company_180,2022-10-14,2023-02-09,2023-02-25,18194,6256,11938
501943,Company_180,2022-08-27,2022-11-09,2023-04-11,7367,2950,4417
501944,Company_180,2023-06-09,2023-09-22,2023-10-25,19405,603,18802
501945,Company_180,2022-08-29,2022-11-25,2023-01-28,16610,4561,12049
501946,Company_180,2022-11-02,2023-02-03,2023-05-26,4957,350,4607
501947,Company_181,2021-01-10,2021-01-31,2021-05-10,13826,12017,1809
501948,Company_181,2020-07-25,2020-08-25,2021-03-06,24070,6439,17631
501949,Company_181,2020-09-15,2020-09-26,2021-01-13,16675,4481,12194
501950,Company_181,2021-10-04,2021-11-29,2022-05-18,13553,12564,989
501951,Company_181,2021-06-12,2021-09-22,2022-01-24,14256,13485,771
501952,Company_181,2022-08-28,2022-11-12,2023-03-30,22647,21288,1359
501953,Company_181,2024-01-09,2024-03-20,2024-03-31,949,899,50
501954,Company_181,2023-05-08,2023-05-20,2023-11-05,13657,392,13265
501955,Company_181,2022-05-07,2022-07-09,2022-08-03,18316,18120,196
501956,Company_181,2021-02-02,2021-03-27,2021-09-18,1720,689,1031
501957,Company_181,2023-05-23,2023-07-09,2023-12-11,16310,4291,12019
501958,Company_181,2023-06-25,2023-09-04,2024-02-04,16983,3023,13960
501959,Company_181,2021-03-09,2021-06-15,2021-12-09,8496,7343,1153
501960,Company_181,2021-06-12,2021-07-15,2022-01-12,14717,7695,7022
501961,Company_181,2021-10-11,2021-11-05,2022-04-06,15858,7577,8281
501962,Company_181,2024-01-16,2024-03-26,2024-07-24,23962,19290,4672
501963,Company_181,2024-01-20,2024-02-12,2024-03-28,14422,12749,1673
501964,Company_181,2020-01-24,2020-05-06,2020-07-06,14049,927,13122
501965,Company_182,2023-09-11,2023-10-06,2024-01-28,14382,3029,11353
501966,Company_182,2022-04-08,2022-05-21,2022-09-14,17172,9363,7809
501967,Company_182,2023-04-08,2023-07-09,2023-08-29,24094,17171,6923
501968,Company_182,2021-08-14,2021-10-15,2022-03-26,4720,1234,3486
501969,Company_182,2022-12-04,2023-01-12,2023-04-12,13087,567,12520
501970,Company_182,2021-11-09,2022-02-15,2022-06-15,17367,10998,6369
501971,Company_182,2021-03-25,2021-04-21,2021-10-22,23411,16064,7347
501972,Company_182,2022-03-21,2022-04-26,2022-08-15,16298,1384,14914
501973,Company_182,2023-10-20,2023-12-23,2024-03-20,17731,6168,11563
501974,Company_182,2023-05-29,2023-06-14,2023-08-18,14256,12086,2170
501975,Company_182,2023-09-01,2023-10-07,2024-04-02,8199,6410,1789
501976,Company_182,2022-12-01,2023-01-14,2023-06-26,22145,8044,14101
501977,Company_183,2023-05-23,2023-07-13,2023-07-13,23266,21114,2152
501978,Company_183,2023-10-11,2023-10-30,2024-01-16,24350,11695,12655
501979,Company_183,2022-05-01,2022-06-05,2022-12-11,16037,12494,3543
501980,Company_183,2020-05-23,2020-07-24,2020-09-12,8503,2016,6487
501981,Company_183,2022-01-25,2022-05-17,2022-08-06,18522,13510,5012
501982,Company_183,2022-10-21,2022-11-15,2022-12-09,21781,10347,11434
501983,Company_183,2023-10-31,2023-12-23,2024-03-24,20854,16940,3914
501984,Company_183,2020-06-12,2020-07-06,2020-11-25,1857,848,1009
501985,Company_183,2020-06-16,2020-09-03,2020-09-26,18744,12709,6035
501986,Company_183,2023-12-20,2024-01-22,2024-05-31,10031,93,9938
501987,Company_183,2021-09-17,2021-11-24,2022-06-06,23769,1168,22601
501988,Company_184,2022-02-05,2022-04-24,2022-05-27,20408,13124,7284
501989,Company_184,2023-05-01,2023-05-26,2023-08-14,10601,8787,1814
501990,Company_184,2021-03-24,2021-05-30,2021-11-09,1616,1080,536
501991,Company_184,2022-01-21,2022-05-11,2022-07-20,19112,637,18475
501992,Company_184,2023-12-09,2024-03-22,2024-04-22,18218,9460,8758
501993,Company_184,2020-02-25,2020-03-10,2020-03-25,2950,1051,1899
501994,Company_184,2021-12-25,2022-01-30,2022-02-25,15850,10638,5212
501995,Company_184,2023-01-06,2023-05-02,2023-10-04,15431,1955,13476
501996,Company_185,2020-11-14,2020-11-27,2021-04-11,12728,7730,4998
501997,Company_185,2023-01-18,2023-04-27,2023-09-03,4946,2247,2699
501998,Company_185,2023-05-15,2023-08-27,2024-01-09,6284,6206,78
501999,Company_185,2021-07-10,2021-09-25,2022-01-14,24640,12903,11737
502000,Company_185,2022-07-16,2022-08-02,2023-01-26,7661,5128,2533
502001,Company_185,2022-05-07,2022-08-31,2022-09-06,7280,4626,2654
502002,Company_185,2022-01-04,2022-03-14,2022-03-21,24097,587,23510
502003,Company_185,2021-11-03,2022-01-14,2022-06-10,1104,575,529
502004,Company_185,2021-01-06,2021-04-22,2021-09-02,8453,5471,2982
502005,Company_185,2022-01-06,2022-03-15,2022-05-15,9062,7744,1318
502006,Company_186,2021-05-07,2021-05-26,2021-10-12,15365,1636,13729
502007,Company_186,2022-08-08,2022-11-08,2023-04-11,6701,1375,5326
502008,Company_186,2021-10-25,2022-02-21,2022-06-02,9053,8428,625
502009,Company_186,2021-01-07,2021-05-04,2021-09-05,13202,7866,5336
502010,Company_186,2020-01-18,2020-03-24,2020-06-28,18243,12825,5418
502011,Company_186,2023-07-16,2023-10-11,2024-01-13,1919,174,1745
502012,Company_187,2022-04-19,2022-06-18,2022-08-07,18735,2386,16349
502013,Company_187,2023-02-14,2023-03-17,2023-08-03,22631,15525,7106
502014,Company_187,2022-04-23,2022-05-23,2022-06-11,13571,5107,8464
502015,Company_187,2023-02-27,2023-06-11,2023-08-13,12911,4270,8641
502016,Company_187,2022-07-25,2022-09-23,2022-10-02,12548,5345,7203
502017,Company_187,2023-08-07,2023-11-14,2024-03-26,8453,4733,3720
502018,Company_187,2020-07-02,2020-08-31,2021-01-24,11696,11211,485
502019,Company_188,2021-06-10,2021-07-09,2021-08-23,24566,14005,10561
502020,Company_188,2023-03-31,2023-04-27,2023-09-17,22987,18432,4555
502021,Company_188,2020-10-12,2020-12-21,2021-06-19,19160,16225,2935
502022,Company_188,2023-07-20,2023-10-23,2024-02-24,826,41,785
502023,Company_188,2021-11-24,2022-01-27,2022-07-13,16753,15162,1591
502024,Company_188,2020-06-10,2020-07-28,2020-09-09,6105,4194,1911
502025,Company_189,2022-03-21,2022-05-25,2022-10-02,3358,2031,1327
502026,Company_189,2021-07-12,2021-09-19,2021-11-07,18768,2420,16348
502027,Company_189,2023-07-12,2023-10-17,2023-10-20,3911,642,3269
502028,Company_189,2022-01-15,2022-04-14,2022-05-05,6815,6075,740
502029,Company_189,2020-11-10,2021-01-11,2021-07-14,17691,4038,13653
502030,Company_189,2021-07-31,2021-10-29,2022-02-01,5752,768,4984
502031,Company_189,2021-08-27,2021-12-04,2022-01-31,23422,4297,19125
502032,Company_189,2021-09-27,2021-10-10,2022-04-07,5460,5297,163
502033,Company_189,2023-12-07,2024-03-30,2024-07-13,23413,303,23110
502034,Company_189,2022-09-29,2022-11-29,2023-01-13,21588,6939,14649
502035,Company_189,2022-07-15,2022-09-25,2023-02-18,11204,8403,2801
502036,Company_189,2021-12-15,2022-03-19,2022-08-11,6373,2235,4138
502037,Company_189,2020-09-13,2020-10-26,2021-02-02,22572,15368,7204
502038,Company_190,2023-03-29,2023-04-14,2023-08-31,6045,5094,951
502039,Company_190,2021-11-29,2022-01-30,2022-05-06,6351,3380,2971
502040,Company_190,2021-06-17,2021-10-13,2022-03-20,23230,11836,11394
502041,Company_190,2023-08-11,2023-10-11,2023-12-08,8760,758,8002
502042,Company_190,2022-05-20,2022-08-15,2022-11-09,16663,3388,13275
502043,Company_190,2020-11-03,2020-12-25,2021-06-24,22168,18604,3564
502044,Company_190,2022-05-24,2022-07-09,2022-08-05,16668,12370,4298
502045,Company_190,2020-10-01,2020-12-26,2021-01-10,3830,1152,2678
502046,Company_190,2021-09-16,2021-12-06,2022-05-20,24419,1443,22976
502047,Company_190,2020-12-23,2021-03-02,2021-07-23,23729,14357,9372
502048,Company_190,2020-07-07,2020-08-14,2020-11-15,9201,1206,7995
502049,Company_190,2020-04-04,2020-05-30,2020-08-23,20500,4567,15933
502050,Company_190,2021-05-22,2021-06-07,2021-11-08,14156,4132,10024
502051,Company_190,2020-06-15,2020-09-18,2020-12-09,12274,3311,8963
502052,Company_191,2022-02-22,2022-05-20,2022-06-19,21147,18782,2365
502053,Company_191,2021-11-10,2021-11-22,2022-01-16,1909,1764,145
502054,Company_191,2020-10-17,2020-12-31,2021-05-12,1854,1220,634
502055,Company_191,2022-04-12,2022-04-22,2022-06-24,12768,7798,4970
502056,Company_191,2022-01-13,2022-02-21,2022-07-31,13263,5920,7343
502057,Company_191,2023-12-31,2024-01-24,2024-05-31,11433,9020,2413
502058,Company_191,2023-02-10,2023-03-31,2023-08-06,15088,12115,2973
502059,Company_191,2023-09-22,2023-11-20,2024-03-25,17326,1839,15487
502060,Company_191,2022-09-05,2022-11-23,2023-02-25,17491,4158,13333
502061,Company_191,2020-08-23,2020-11-30,2021-03-08,3462,3269,193
502062,Company_191,2022-03-16,2022-05-17,2022-07-30,9025,7044,1981
502063,Company_191,2021-06-02,2021-09-04,2022-02-24,24612,9285,15327
502064,Company_191,2024-01-05,2024-04-21,2024-09-21,12983,5929,7054
502065,Company_191,2021-11-08,2022-01-20,2022-04-09,24097,13216,10881
502066,Company_191,2022-06-09,2022-07-31,2022-12-04,22077,13924,8153
502067,Company_191,2023-05-06,2023-06-30,2023-08-06,13616,5844,7772
502068,Company_191,2021-05-14,2021-07-27,2021-10-04,9705,4263,5442
502069,Company_191,2021-07-18,2021-09-22,2021-10-16,8984,7067,1917
502070,Company_192,2020-08-01,2020-11-13,2021-01-27,22549,192,22357
502071,Company_192,2024-02-04,2024-04-04,2024-05-11,18033,16773,1260
502072,Company_192,2021-09-13,2021-09-26,2021-12-20,15264,15208,56
502073,Company_192,2021-08-12,2021-11-07,2022-03-20,13482,2811,10671
502074,Company_192,2022-08-23,2022-10-31,2023-01-10,5634,1915,3719
502075,Company_192,2023-06-23,2023-08-06,2023-11-23,13547,10214,3333
502076,Company_192,2021-06-23,2021-10-01,2022-01-04,7220,7141,79
502077,Company_192,2023-10-19,2024-01-06,2024-03-05,6790,5548,1242
502078,Company_192,2021-08-08,2021-09-29,2022-04-02,16655,2364,14291
502079,Company_192,2021-09-27,2021-11-21,2022-04-30,12060,6528,5532
502080,Company_192,2021-08-04,2021-12-01,2022-04-26,14114,2086,12028
502081,Company_193,2022-06-01,2022-09-01,2023-03-04,23273,478,22795
502082,Company_193,2022-04-29,2022-05-31,2022-11-06,21275,13144,8131
502083,Company_193,2021-12-16,2022-03-02,2022-05-06,4013,2592,1421
502084,Company_193,2022-01-01,2022-01-21,2022-07-30,16600,13163,3437
502085,Company_193,2023-06-11,2023-09-29,2023-10-19,4748,4142,606
502086,Company_193,2020-07-23,2020-11-06,2021-02-25,21038,14864,6174
502087,Company_193,2020-10-03,2020-11-10,2021-05-18,1730,440,1290
502088,Company_193,2022-05-14,2022-07-11,2022-07-28,5441,4768,673
502089,Company_193,2020-10-26,2020-11-24,2021-01-24,16319,7513,8806
502090,Company_193,2020-08-05,2020-10-08,2020-11-10,7164,1428,5736
502091,Company_193,2021-03-19,2021-03-31,2021-05-25,6632,1821,4811
502092,Company_194,2021-01-26,2021-03-28,2021-07-09,7252,6208,1044
502093,Company_194,2021-06-03,2021-09-04,2022-02-26,4807,872,3935
502094,Company_194,2021-06-19,2021-07-05,2021-12-09,20536,16525,4011
502095,Company_194,2022-08-19,2022-11-28,2023-05-30,16020,3312,12708
502096,Company_194,2020-07-10,2020-08-08,2020-09-19,22332,5506,16826
502097,Company_194,2020-11-02,2021-02-21,2021-06-18,7397,4718,2679
502098,Company_194,2023-06-06,2023-07-20,2023-10-09,17100,2458,14642
502099,Company_194,2021-04-30,2021-08-12,2021-10-26,17512,15985,1527
502100,Company_194,2020-11-01,2021-01-01,2021-02-19,5331,515,4816
502101,Company_194,2022-01-02,2022-04-22,2022-07-11,8708,2990,5718
502102,Company_194,2020-06-10,2020-08-08,2020-12-15,893,107,786
502103,Company_194,2021-03-30,2021-07-26,2022-02-01,10126,8334,1792
502104,Company_195,2023-02-18,2023-06-05,2023-08-15,5397,5063,334
502105,Company_195,2022-01-01,2022-01-19,2022-05-23,24394,15649,8745
502106,Company_195,2020-02-15,2020-03-06,2020-03-25,15278,2206,13072
502107,Company_195,2021-08-27,2021-11-22,2021-11-27,13909,3380,10529
502108,Company_195,2022-03-24,2022-05-13,2022-11-16,11461,6191,5270
502109,Company_195,2021-05-07,2021-05-26,2021-09-24,3257,2459,798
502110,Company_195,2020-01-28,2020-03-28,2020-04-09,5417,3470,1947
502111,Company_195,2023-05-27,2023-06-22,2023-11-19,3459,758,2701
502112,Company_195,2023-08-25,2023-11-01,2023-11-22,19958,3044,16914
502113,Company_195,2022-07-23,2022-10-01,2023-03-31,4989,2621,2368
502114,Company_195,2021-06-22,2021-07-06,2021-10-22,21144,1216,19928
502115,Company_195,2022-09-14,2022-11-06,2023-01-17,17412,8212,9200
502116,Company_195,2020-07-06,2020-10-03,2021-01-03,16144,10596,5548
502117,Company_195,2022-04-19,2022-08-04,2023-02-07,24446,5702,18744
502118,Company_196,2020-08-31,2020-09-17,2020-11-21,8542,1189,7353
502119,Company_196,2024-01-12,2024-02-04,2024-02-19,22128,6868,15260
502120,Company_196,2021-06-06,2021-10-01,2022-04-14,5211,3039,2172
502121,Company_196,2020-08-16,2020-10-26,2021-01-24,2155,1297,858
502122,Company_196,2023-04-13,2023-08-01,2024-02-16,1618,1315,303
502123,Company_196,2021-06-03,2021-06-16,2021-11-21,24686,6546,18140
502124,Company_196,2023-03-28,2023-05-24,2023-10-11,14591,811,13780
502125,Company_196,2022-03-13,2022-04-09,2022-08-12,8868,5997,2871
502126,Company_196,2021-05-05,2021-06-05,2021-12-13,9642,5706,3936
502127,Company_196,2023-05-05,2023-08-30,2023-09-13,13584,5043,8541
502128,Company_196,2021-04-22,2021-08-14,2022-02-09,14613,12007,2606
502129,Company_196,2023-10-07,2024-01-15,2024-04-19,12535,3520,9015
502130,Company_196,2021-04-14,2021-07-29,2021-10-23,19660,4278,15382
502131,Company_197,2021-01-24,2021-05-09,2021-10-03,11071,5285,5786
502132,Company_197,2020-04-04,2020-05-11,2020-09-20,22854,7333,15521
502133,Company_198,2023-05-29,2023-08-24,2024-02-17,15806,4887,10919
502134,Company_198,2020-02-07,2020-02-24,2020-07-01,11241,6739,4502
502135,Company_198,2023-06-26,2023-07-15,2023-07-26,14206,11316,2890
502136,Company_198,2021-04-18,2021-08-14,2022-02-25,21923,3248,18675
502137,Company_199,2021-02-23,2021-03-27,2021-08-31,17928,8652,9276
502138,Company_199,2021-06-03,2021-06-26,2021-12-06,16217,7898,8319
502139,Company_199,2022-05-24,2022-06-30,2022-09-07,23113,13813,9300
502140,Company_199,2023-04-29,2023-05-30,2023-07-31,21855,6731,15124
502141,Company_200,2022-12-19,2023-03-10,2023-04-10,19881,10844,9037
502142,Company_200,2021-08-20,2021-09-23,2022-02-05,15455,3236,12219
502143,Company_200,2021-07-14,2021-08-09,2021-12-25,4027,603,3424
502144,Company_200,2021-05-24,2021-06-03,2021-09-10,8412,4333,4079
502145,Company_200,2023-06-29,2023-08-24,2023-09-20,11343,9027,2316
502146,Company_200,2020-09-09,2020-10-20,2020-12-19,2724,1266,1458
502147,Company_200,2024-02-01,2024-05-12,2024-07-12,10057,5923,4134
502148,Company_200,2023-05-08,2023-08-14,2023-09-19,9559,230,9329
502149,Company_200,2021-04-29,2021-06-04,2021-11-27,7018,887,6131
502150,Company_200,2020-12-13,2020-12-27,2021-03-11,20332,6883,13449
502151,Company_200,2022-07-05,2022-08-28,2022-11-15,2511,354,2157
502152,Company_200,2023-10-04,2023-12-11,2023-12-15,836,85,751
502153,Company_200,2021-01-12,2021-01-25,2021-06-02,10639,6756,3883
502154,Company_200,2022-02-08,2022-04-07,2022-06-12,12580,10442,2138
502155,Company_200,2021-08-29,2021-11-22,2022-02-07,6722,4532,2190
502156,Company_200,2021-01-08,2021-03-21,2021-07-26,13909,2177,11732
502157,Company_200,2020-07-02,2020-09-02,2020-10-11,23567,4341,19226
502158,Company_200,2023-11-17,2024-02-23,2024-05-22,9004,3500,5504
502159,Company_200,2020-04-22,2020-08-16,2020-10-07,2016,669,1347
502160,Company_201,2020-12-30,2021-02-13,2021-08-28,15030,5628,9402
502161,Company_201,2020-12-26,2021-02-02,2021-07-08,17037,9537,7500
502162,Company_201,2023-01-24,2023-04-07,2023-05-15,8690,4876,3814
502163,Company_201,2020-07-31,2020-10-24,2020-11-15,6338,1133,5205
502164,Company_201,2023-02-04,2023-04-17,2023-06-12,4840,3210,1630
502165,Company_201,2020-08-07,2020-10-04,2021-01-08,8908,5243,3665
502166,Company_201,2022-07-13,2022-08-10,2022-10-03,10194,6183,4011
502167,Company_201,2021-08-13,2021-11-05,2022-03-15,13714,11897,1817
502168,Company_201,2021-09-12,2021-12-03,2021-12-22,9368,7983,1385
502169,Company_201,2022-06-10,2022-07-29,2022-09-18,18739,7767,10972
502170,Company_201,2022-04-02,2022-07-27,2022-08-16,8343,5227,3116
502171,Company_201,2024-01-25,2024-03-19,2024-07-13,9790,269,9521
502172,Company_201,2022-09-22,2022-12-07,2023-04-10,9847,6951,2896
502173,Company_201,2021-09-14,2021-11-19,2022-01-07,1403,679,724
502174,Company_201,2020-12-29,2021-04-03,2021-04-27,21373,697,20676
502175,Company_202,2020-12-02,2021-01-02,2021-05-07,5108,5022,86
502176,Company_202,2024-01-05,2024-04-04,2024-07-22,10583,4739,5844
502177,Company_202,2022-06-14,2022-08-11,2022-10-09,20185,16590,3595
502178,Company_202,2022-01-13,2022-04-27,2022-07-10,2774,201,2573
502179,Company_202,2023-11-26,2023-12-15,2024-05-13,17916,13910,4006
502180,Company_203,2020-05-27,2020-08-22,2021-03-07,12092,10390,1702
502181,Company_203,2020-12-17,2021-03-29,2021-08-08,20981,6574,14407
502182,Company_203,2020-05-10,2020-06-03,2020-07-04,21900,12255,9645
502183,Company_203,2023-05-11,2023-06-19,2023-11-22,23609,19380,4229
502184,Company_203,2023-06-12,2023-10-02,2023-10-28,1631,910,721
502185,Company_203,2021-12-11,2022-03-29,2022-04-05,5044,1270,3774
502186,Company_203,2023-04-20,2023-08-02,2024-01-13,21911,8784,13127
502187,Company_203,2022-07-06,2022-07-16,2022-10-26,19333,10865,8468
502188,Company_203,2022-07-25,2022-10-23,2023-02-09,13391,1768,11623
502189,Company_203,2022-01-31,2022-03-11,2022-06-29,21321,8714,12607
502190,Company_203,2021-04-22,2021-08-10,2021-08-28,12792,5081,7711
502191,Company_204,2021-03-05,2021-04-27,2021-06-25,3041,1367,1674
502192,Company_204,2021-06-17,2021-09-14,2021-11-13,15703,7417,8286
502193,Company_204,2023-02-13,2023-04-27,2023-06-06,9569,4085,5484
502194,Company_204,2023-02-09,2023-03-28,2023-07-02,19349,365,18984
502195,Company_204,2022-02-19,2022-05-20,2022-09-20,7992,7160,832
502196,Company_204,2020-02-08,2020-03-23,2020-07-26,9352,5998,3354
502197,Company_204,2021-12-29,2022-02-19,2022-05-24,2977,1764,1213
502198,Company_204,2024-01-19,2024-03-13,2024-08-01,6715,5721,994
502199,Company_204,2021-05-24,2021-08-24,2021-11-19,19068,3485,15583
502200,Company_204,2021-02-02,2021-05-20,2021-07-14,21170,19578,1592
502201,Company_204,2021-07-04,2021-09-07,2021-09-19,11096,6889,4207
502202,Company_204,2020-05-21,2020-07-07,2020-09-07,10651,8388,2263
502203,Company_204,2021-12-08,2022-03-26,2022-08-05,10278,3792,6486
502204,Company_205,2020-12-30,2021-04-07,2021-07-13,12225,11236,989
502205,Company_205,2022-12-29,2023-02-01,2023-08-14,16708,1617,15091
502206,Company_206,2022-08-06,2022-10-11,2023-03-14,7537,3071,4466
502207,Company_206,2020-02-17,2020-04-11,2020-05-31,15198,916,14282
502208,Company_206,2021-01-13,2021-05-08,2021-07-31,10811,10549,262
502209,Company_206,2020-05-22,2020-07-06,2020-12-22,17046,8027,9019
502210,Company_206,2020-08-24,2020-10-09,2020-12-14,19833,10409,9424
502211,Company_206,2023-05-12,2023-06-08,2023-06-08,10139,1869,8270
502212,Company_206,2022-03-12,2022-03-30,2022-08-29,8910,1979,6931
502213,Company_206,2021-09-29,2021-11-28,2022-04-25,20055,19044,1011
502214,Company_206,2022-05-29,2022-08-28,2023-02-22,21522,15544,5978
502215,Company_206,2021-10-18,2022-01-08,2022-01-13,19536,12197,7339
502216,Company_206,2023-03-23,2023-05-16,2023-10-29,11783,5419,6364
502217,Company_206,2023-10-14,2024-01-09,2024-03-26,2165,737,1428
502218,Company_206,2022-07-05,2022-08-13,2022-12-28,17116,15935,1181
502219,Company_206,2020-12-30,2021-04-17,2021-06-01,21238,8091,13147
502220,Company_206,2020-01-21,2020-03-25,2020-07-27,12864,2373,10491
502221,Company_206,2020-12-21,2021-02-07,2021-04-30,2022,1640,382
502222,Company_206,2023-05-30,2023-06-23,2023-12-28,22375,18011,4364
502223,Company_206,2021-11-11,2022-02-23,2022-05-14,23301,10933,12368
502224,Company_206,2023-01-16,2023-04-01,2023-08-14,6417,31,6386
502225,Company_207,2020-07-29,2020-10-15,2021-03-26,4956,518,4438
502226,Company_207,2020-08-08,2020-12-01,2020-12-06,24070,5900,18170
502227,Company_207,2022-05-14,2022-07-01,2022-10-09,2039,75,1964
502228,Company_207,2020-04-09,2020-06-14,2020-11-07,10734,8654,2080
502229,Company_207,2022-05-19,2022-06-24,2022-12-27,13752,6827,6925
502230,Company_207,2020-02-01,2020-05-25,2020-11-26,12706,2479,10227
502231,Company_207,2022-01-06,2022-04-25,2022-08-20,13558,11847,1711
502232,Company_207,2022-11-19,2023-01-30,2023-06-12,6496,2817,3679
502233,Company_207,2020-01-02,2020-03-27,2020-09-15,5690,5504,186
502234,Company_207,2023-06-04,2023-09-05,2023-12-13,2179,285,1894
502235,Company_207,2022-01-24,2022-04-26,2022-05-16,9154,7019,2135
502236,Company_207,2023-12-16,2024-03-13,2024-04-26,22114,979,21135
502237,Company_207,2022-01-01,2022-02-18,2022-04-22,3845,2728,1117
502238,Company_207,2023-03-09,2023-07-01,2023-10-23,16943,4338,12605
502239,Company_207,2023-11-01,2023-12-31,2024-02-23,16344,15126,1218
502240,Company_208,2023-04-12,2023-07-25,2023-10-21,19949,5140,14809
502241,Company_208,2022-09-08,2022-11-10,2022-12-18,14265,4326,9939
502242,Company_208,2021-09-19,2022-01-03,2022-03-06,20471,15513,4958
502243,Company_208,2023-11-14,2024-01-05,2024-02-16,17504,5965,11539
502244,Company_208,2023-01-20,2023-03-16,2023-06-28,13622,6658,6964
502245,Company_208,2020-06-15,2020-10-10,2021-04-20,13060,8249,4811
502246,Company_208,2021-04-17,2021-07-30,2021-10-15,19284,3439,15845
502247,Company_208,2022-10-08,2022-12-30,2023-01-26,1230,44,1186
502248,Company_208,2022-06-21,2022-10-01,2023-04-03,8468,51,8417
502249,Company_208,2022-06-15,2022-09-14,2022-11-30,12390,5085,7305
502250,Company_208,2020-08-02,2020-10-04,2021-03-13,3926,2266,1660
502251,Company_208,2020-01-05,2020-05-01,2020-07-23,7636,1539,6097
502252,Company_208,2022-06-04,2022-09-26,2023-02-01,9563,440,9123
502253,Company_208,2020-08-03,2020-08-28,2021-01-01,1065,112,953
502254,Company_208,2022-07-19,2022-08-03,2022-11-03,21038,11212,9826
502255,Company_208,2023-09-18,2023-10-03,2023-10-11,9052,2103,6949
502256,Company_208,2023-06-24,2023-09-05,2024-01-11,18163,17618,545
502257,Company_208,2022-05-11,2022-07-05,2022-07-23,19746,13619,6127
502258,Company_208,2023-05-10,2023-06-24,2023-09-22,3766,60,3706
502259,Company_209,2022-06-02,2022-08-05,2022-08-25,2512,2080,432
502260,Company_209,2020-01-30,2020-05-03,2020-09-08,13354,6295,7059
502261,Company_209,2020-10-24,2021-01-04,2021-07-10,5118,525,4593
502262,Company_209,2021-04-05,2021-07-14,2021-09-13,18252,4607,13645
502263,Company_209,2022-10-15,2022-11-05,2023-04-04,24403,7801,16602
502264,Company_209,2020-09-19,2020-12-10,2021-01-20,18718,10774,7944
502265,Company_210,2021-10-19,2022-02-12,2022-06-27,23102,9290,13812
502266,Company_210,2020-04-09,2020-05-22,2020-06-18,16652,2948,13704
502267,Company_210,2020-05-15,2020-08-25,2020-10-02,8596,5987,2609
502268,Company_210,2020-06-27,2020-09-10,2020-11-30,8087,2843,5244
502269,Company_210,2020-12-15,2021-01-09,2021-06-20,18013,1081,16932
502270,Company_210,2022-09-13,2022-11-30,2023-04-09,16940,2293,14647
502271,Company_210,2022-12-24,2023-02-05,2023-04-06,9070,783,8287
502272,Company_210,2022-12-28,2023-04-22,2023-05-01,8389,3117,5272
502273,Company_210,2022-02-07,2022-06-01,2022-08-10,24761,1182,23579
502274,Company_211,2021-01-23,2021-03-20,2021-06-02,16266,6266,10000
502275,Company_211,2021-03-28,2021-05-02,2021-06-19,12074,803,11271
502276,Company_211,2023-06-13,2023-10-07,2024-04-23,4549,3246,1303
502277,Company_211,2022-07-26,2022-11-21,2023-03-23,20793,13180,7613
502278,Company_211,2023-07-01,2023-10-23,2024-01-11,15264,5454,9810
502279,Company_212,2021-01-16,2021-05-01,2021-09-19,16970,12660,4310
502280,Company_212,2023-12-19,2024-03-07,2024-09-14,12925,10933,1992
502281,Company_212,2020-03-15,2020-07-07,2021-01-08,23977,2162,21815
502282,Company_212,2020-05-14,2020-09-06,2020-12-25,20547,4950,15597
502283,Company_212,2022-09-15,2022-10-18,2023-04-22,16670,8453,8217
502284,Company_212,2020-06-25,2020-08-10,2020-08-28,2945,1560,1385
502285,Company_212,2023-03-04,2023-06-16,2023-10-24,3109,997,2112
502286,Company_212,2020-05-25,2020-06-23,2020-11-30,2610,1642,968
502287,Company_213,2022-05-04,2022-05-31,2022-09-10,8499,3850,4649
502288,Company_213,2021-08-04,2021-09-03,2022-01-09,24298,21187,3111
502289,Company_213,2021-06-02,2021-06-20,2021-08-23,17977,905,17072
502290,Company_213,2023-03-10,2023-05-18,2023-07-27,2124,1608,516
502291,Company_213,2023-02-17,2023-04-20,2023-09-13,13314,12840,474
502292,Company_213,2023-02-24,2023-04-08,2023-06-07,21433,5677,15756
502293,Company_213,2023-01-12,2023-03-25,2023-09-04,9925,507,9418
502294,Company_213,2020-11-02,2021-01-17,2021-03-10,9507,428,9079
502295,Company_213,2022-02-02,2022-03-04,2022-04-17,7474,2268,5206
502296,Company_213,2022-11-22,2023-01-05,2023-03-29,23638,22137,1501
502297,Company_213,2021-09-01,2021-10-16,2022-04-04,12688,10432,2256
502298,Company_213,2021-08-22,2021-11-15,2022-01-23,13997,10983,3014
502299,Company_213,2021-08-09,2021-09-19,2021-09-28,8433,4508,3925
502300,Company_213,2021-09-03,2021-11-06,2021-12-06,17041,15284,1757
502301,Company_213,2021-12-30,2022-03-22,2022-05-28,10684,1482,9202
502302,Company_213,2022-02-17,2022-05-31,2022-10-01,14650,12596,2054
502303,Company_213,2022-06-10,2022-08-16,2022-10-14,12050,5198,6852
502304,Company_213,2022-02-09,2022-04-12,2022-09-09,11389,9131,2258
502305,Company_213,2020-02-21,2020-03-31,2020-05-17,14031,9127,4904
502306,Company_214,2023-06-18,2023-08-16,2023-09-12,13010,4959,8051
502307,Company_214,2023-12-23,2024-02-09,2024-04-15,14501,471,14030
502308,Company_214,2021-04-07,2021-04-28,2021-07-28,3202,2067,1135
502309,Company_214,2020-11-26,2021-03-10,2021-05-14,6381,4825,1556
502310,Company_214,2022-02-17,2022-05-25,2022-10-09,8985,4387,4598
502311,Company_214,2023-05-08,2023-08-30,2024-02-12,13241,4075,9166
502312,Company_214,2021-01-09,2021-02-11,2021-08-06,3180,796,2384
502313,Company_214,2020-03-06,2020-04-03,2020-06-28,16877,4418,12459
502314,Company_214,2023-03-15,2023-05-15,2023-06-19,13923,6103,7820
502315,Company_214,2020-01-30,2020-03-08,2020-07-14,7240,1574,5666
502316,Company_214,2021-10-31,2021-12-29,2022-01-16,12926,8585,4341
502317,Company_214,2021-04-17,2021-05-21,2021-09-23,10867,3088,7779
502318,Company_214,2022-05-02,2022-08-27,2022-10-05,14876,11212,3664
502319,Company_214,2023-03-31,2023-07-08,2023-09-03,5843,5271,572
502320,Company_214,2023-11-24,2024-03-13,2024-06-17,15782,15476,306
502321,Company_215,2020-04-21,2020-05-15,2020-07-17,2360,1525,835
502322,Company_215,2021-08-17,2021-09-29,2021-11-13,8961,8030,931
502323,Company_215,2023-12-09,2024-01-16,2024-01-21,2174,166,2008
502324,Company_215,2020-05-09,2020-08-28,2021-01-11,15530,14056,1474
502325,Company_215,2020-07-06,2020-07-17,2020-12-24,12856,12200,656
502326,Company_215,2023-11-02,2024-02-09,2024-07-12,19155,16953,2202
502327,Company_215,2021-07-05,2021-09-15,2022-03-18,23120,19171,3949
502328,Company_215,2023-03-15,2023-06-13,2023-11-05,20468,10534,9934
502329,Company_215,2022-10-08,2022-11-16,2023-03-27,12684,4130,8554
502330,Company_215,2022-03-26,2022-07-12,2022-10-25,8839,6877,1962
502331,Company_215,2023-07-30,2023-09-15,2024-01-11,18860,424,18436
502332,Company_215,2020-04-19,2020-06-17,2020-12-17,4740,674,4066
502333,Company_215,2023-04-05,2023-05-09,2023-07-05,8724,5035,3689
502334,Company_215,2022-03-24,2022-04-29,2022-10-22,8015,2436,5579
502335,Company_215,2023-12-24,2024-03-05,2024-05-02,9522,6763,2759
502336,Company_215,2022-02-16,2022-06-13,2022-08-28,21396,4326,17070
502337,Company_215,2023-12-16,2024-01-19,2024-03-22,3010,322,2688
502338,Company_216,2020-08-19,2020-10-31,2020-12-29,3933,989,2944
502339,Company_216,2020-11-01,2020-12-12,2021-05-30,22368,12360,10008
502340,Company_216,2023-04-21,2023-08-18,2024-01-24,4676,283,4393
502341,Company_216,2020-05-26,2020-09-20,2021-02-07,13248,7016,6232
502342,Company_216,2021-05-15,2021-06-05,2021-07-25,3412,1969,1443
502343,Company_216,2021-10-27,2022-02-07,2022-02-09,22385,18563,3822
502344,Company_216,2022-04-19,2022-05-17,2022-07-08,17845,8236,9609
502345,Company_216,2020-06-20,2020-08-08,2020-12-02,11840,4705,7135
502346,Company_216,2021-10-02,2021-12-25,2022-06-16,6520,1681,4839
502347,Company_216,2020-07-26,2020-10-12,2020-10-25,24533,14173,10360
502348,Company_216,2021-04-25,2021-06-05,2021-11-09,20896,7865,13031
502349,Company_216,2020-04-26,2020-06-21,2020-08-30,17051,11517,5534
502350,Company_216,2023-08-28,2023-09-28,2024-03-29,22692,4430,18262
502351,Company_216,2020-08-04,2020-09-16,2020-11-17,10221,3870,6351
502352,Company_217,2023-07-24,2023-09-13,2024-02-03,7572,550,7022
502353,Company_217,2022-01-08,2022-04-13,2022-07-29,2963,865,2098
502354,Company_217,2020-06-18,2020-09-14,2020-11-02,5281,4013,1268
502355,Company_217,2022-12-14,2023-03-28,2023-08-08,11959,377,11582
502356,Company_217,2023-08-14,2023-11-01,2024-05-05,21955,14115,7840
502357,Company_217,2020-07-05,2020-10-18,2021-02-28,922,238,684
502358,Company_217,2023-03-26,2023-04-13,2023-06-07,4851,1887,2964
502359,Company_217,2023-03-14,2023-04-30,2023-05-03,14157,12247,1910
502360,Company_217,2022-01-08,2022-01-21,2022-03-03,17079,5481,11598
502361,Company_217,2020-05-16,2020-08-15,2020-08-19,24762,18184,6578
502362,Company_217,2021-03-22,2021-06-14,2021-12-25,12653,4418,8235
502363,Company_217,2023-03-24,2023-04-03,2023-06-21,20572,19183,1389
502364,Company_217,2023-11-25,2024-01-17,2024-06-23,17636,681,16955
502365,Company_217,2023-09-05,2023-11-20,2024-03-18,17567,5105,12462
502366,Company_217,2022-12-31,2023-04-13,2023-04-13,4581,4503,78
502367,Company_217,2023-03-09,2023-06-12,2023-09-07,20042,825,19217
502368,Company_217,2023-01-21,2023-03-30,2023-06-21,4350,2089,2261
502369,Company_218,2022-01-01,2022-04-16,2022-06-24,5558,1164,4394
502370,Company_218,2022-12-21,2023-04-06,2023-05-26,12189,1284,10905
502371,Company_218,2023-01-02,2023-03-06,2023-07-25,9414,6308,3106
502372,Company_218,2021-11-06,2022-01-11,2022-04-16,1422,751,671
502373,Company_218,2021-05-02,2021-07-23,2021-09-26,21645,13280,8365
502374,Company_218,2024-01-03,2024-02-25,2024-05-24,10558,2506,8052
502375,Company_218,2022-12-27,2023-02-01,2023-08-13,1538,1140,398
502376,Company_218,2020-10-30,2021-01-27,2021-06-02,19672,15918,3754
502377,Company_218,2022-07-10,2022-07-28,2023-01-12,19749,12221,7528
502378,Company_218,2020-02-20,2020-05-06,2020-10-16,20670,5814,14856
502379,Company_218,2023-09-13,2023-10-20,2024-01-20,12387,5842,6545
502380,Company_218,2021-09-26,2021-12-21,2022-05-27,23378,20907,2471
502381,Company_219,2021-10-05,2021-11-06,2022-05-10,15550,3069,12481
502382,Company_219,2022-02-22,2022-04-12,2022-08-15,16186,15601,585
502383,Company_219,2022-04-23,2022-07-31,2022-12-31,19142,17334,1808
502384,Company_219,2023-03-01,2023-05-17,2023-08-08,23668,5114,18554
502385,Company_219,2020-05-24,2020-07-21,2020-10-28,7784,5168,2616
502386,Company_219,2021-03-11,2021-06-19,2021-09-30,4395,3763,632
502387,Company_219,2022-03-17,2022-06-13,2022-08-09,14277,9785,4492
502388,Company_219,2021-01-31,2021-03-31,2021-04-06,12806,3859,8947
502389,Company_219,2021-02-15,2021-04-05,2021-04-30,3945,1682,2263
502390,Company_219,2021-12-03,2022-01-19,2022-03-26,11633,5231,6402
502391,Company_219,2020-12-03,2021-03-09,2021-09-04,23208,13940,9268
502392,Company_219,2021-05-04,2021-07-29,2022-01-14,1660,1200,460
502393,Company_219,2020-12-30,2021-02-23,2021-03-17,848,523,325
502394,Company_219,2021-10-14,2021-11-03,2022-01-08,2455,2424,31
502395,Company_219,2020-11-02,2021-01-20,2021-04-17,16120,11740,4380
502396,Company_219,2020-05-07,2020-07-21,2021-01-30,21840,2022,19818
502397,Company_219,2022-12-02,2023-02-15,2023-06-21,16491,14555,1936
502398,Company_219,2022-07-19,2022-08-22,2022-10-20,23389,5477,17912
502399,Company_219,2022-08-29,2022-10-25,2022-12-01,15383,11036,4347
502400,Company_220,2022-02-03,2022-03-19,2022-06-23,17087,13255,3832
502401,Company_220,2021-10-13,2021-11-19,2022-04-28,23300,14818,8482
502402,Company_220,2023-05-05,2023-07-21,2023-09-11,6325,2967,3358
502403,Company_220,2023-04-05,2023-06-01,2023-09-25,13494,5670,7824
502404,Company_220,2023-08-30,2023-10-07,2024-01-16,9790,3139,6651
502405,Company_220,2022-03-07,2022-06-28,2022-09-21,856,574,282
502406,Company_221,2022-12-17,2023-04-03,2023-08-17,6005,857,5148
502407,Company_221,2022-06-12,2022-10-06,2022-11-28,8062,7534,528
502408,Company_221,2022-01-02,2022-04-18,2022-09-21,6086,599,5487
502409,Company_221,2020-04-10,2020-07-04,2020-08-13,19157,11779,7378
502410,Company_221,2022-05-15,2022-08-11,2022-12-30,2647,562,2085
502411,Company_221,2021-03-17,2021-05-19,2021-06-18,10220,9579,641
502412,Company_222,2020-12-23,2021-01-16,2021-06-26,22612,10611,12001
502413,Company_222,2021-03-09,2021-04-11,2021-05-31,2143,214,1929
502414,Company_222,2022-10-29,2023-01-14,2023-07-23,17617,4512,13105
502415,Company_222,2020-02-18,2020-04-10,2020-08-21,6370,2550,3820
502416,Company_222,2022-09-23,2022-12-22,2023-04-21,19556,18281,1275
502417,Company_222,2023-10-01,2023-10-12,2023-12-30,7957,7053,904
502418,Company_222,2023-02-01,2023-05-12,2023-09-29,15743,13611,2132
502419,Company_222,2022-11-07,2022-12-19,2023-06-30,4915,1479,3436
502420,Company_223,2021-02-21,2021-05-13,2021-10-09,858,491,367
502421,Company_223,2022-09-19,2022-12-26,2023-03-07,17921,15161,2760
502422,Company_223,2021-06-04,2021-06-24,2021-10-06,14265,13668,597
502423,Company_223,2021-01-25,2021-03-31,2021-10-11,12209,5769,6440
502424,Company_223,2021-12-01,2022-01-24,2022-08-01,3313,2701,612
502425,Company_223,2021-08-20,2021-10-28,2021-12-25,24957,21459,3498
502426,Company_223,2022-03-13,2022-05-13,2022-10-17,5286,1025,4261
502427,Company_223,2022-04-29,2022-05-11,2022-09-25,8358,3,8355
502428,Company_223,2022-08-15,2022-11-24,2023-03-04,24308,1623,22685
502429,Company_223,2020-10-15,2021-01-29,2021-03-09,18651,15235,3416
502430,Company_223,2020-04-12,2020-05-22,2020-07-29,22396,6919,15477
502431,Company_223,2020-08-17,2020-11-11,2021-01-06,11409,6033,5376
502432,Company_224,2020-06-04,2020-08-17,2020-12-17,14668,6723,7945
502433,Company_224,2023-05-19,2023-09-06,2024-03-03,2611,2352,259
502434,Company_224,2021-10-03,2022-01-19,2022-08-04,5144,3437,1707
502435,Company_224,2022-06-09,2022-08-29,2023-02-19,21490,4234,17256
502436,Company_224,2022-04-16,2022-08-02,2022-10-08,23062,192,22870
502437,Company_224,2021-01-23,2021-03-23,2021-06-10,7552,3981,3571
502438,Company_224,2022-12-05,2022-12-27,2023-06-26,2539,1077,1462
502439,Company_224,2021-04-12,2021-06-05,2021-10-24,3437,2817,620
502440,Company_224,2021-06-28,2021-10-24,2021-12-17,1300,1004,296
502441,Company_225,2021-08-21,2021-09-30,2021-11-05,21271,550,20721
502442,Company_225,2020-11-01,2020-12-01,2021-04-17,7153,3589,3564
502443,Company_225,2021-12-27,2022-04-19,2022-05-30,800,232,568
502444,Company_225,2021-10-30,2022-01-12,2022-07-18,11900,7248,4652
502445,Company_225,2021-04-24,2021-06-23,2021-06-24,12791,11944,847
502446,Company_225,2020-11-03,2021-02-28,2021-03-29,10833,1094,9739
502447,Company_225,2023-01-19,2023-03-11,2023-04-23,16645,1356,15289
502448,Company_225,2023-08-02,2023-09-29,2023-12-28,4464,2562,1902
502449,Company_225,2023-07-21,2023-10-06,2024-02-22,23604,4392,19212
502450,Company_225,2022-05-08,2022-05-19,2022-11-04,23401,10464,12937
502451,Company_225,2020-03-11,2020-06-03,2020-11-12,12658,2140,10518
502452,Company_225,2022-04-28,2022-07-25,2022-12-12,13238,5306,7932
502453,Company_226,2022-06-22,2022-09-27,2023-03-14,13042,7675,5367
502454,Company_226,2023-02-18,2023-05-29,2023-07-05,9114,8978,136
502455,Company_226,2023-03-13,2023-03-30,2023-04-09,21785,6411,15374
502456,Company_226,2024-01-19,2024-03-27,2024-08-29,9444,2392,7052
502457,Company_226,2023-01-25,2023-04-02,2023-04-14,13116,10359,2757
502458,Company_226,2023-12-13,2024-03-03,2024-08-02,19837,19315,522
502459,Company_226,2020-11-29,2021-01-10,2021-07-18,9589,7587,2002
502460,Company_226,2022-05-17,2022-08-24,2022-10-03,9571,7466,2105
502461,Company_226,2020-11-04,2020-12-06,2021-05-03,16434,1323,15111
502462,Company_226,2023-08-24,2023-12-01,2024-04-30,13090,3412,9678
502463,Company_226,2022-04-18,2022-08-11,2022-12-18,19203,12018,7185
502464,Company_226,2023-06-04,2023-07-13,2023-11-12,17113,6476,10637
502465,Company_226,2023-12-14,2024-02-06,2024-03-10,18154,2424,15730
502466,Company_226,2022-07-17,2022-11-01,2023-03-09,4517,1310,3207
502467,Company_226,2024-02-03,2024-05-29,2024-09-13,12787,7768,5019
502468,Company_226,2022-08-22,2022-09-13,2022-09-19,9136,5971,3165
502469,Company_226,2023-01-12,2023-04-29,2023-09-27,6112,5325,787
502470,Company_226,2021-10-10,2021-11-16,2022-01-11,23641,11371,12270
502471,Company_226,2021-08-16,2021-11-18,2021-12-30,17142,14029,3113
502472,Company_227,2022-09-10,2022-12-14,2023-04-23,15653,3416,12237
502473,Company_227,2021-05-05,2021-08-27,2021-11-11,20040,5856,14184
502474,Company_227,2023-09-19,2023-11-16,2024-05-24,20909,6146,14763
502475,Company_227,2020-07-15,2020-09-27,2021-04-06,18759,12673,6086
502476,Company_228,2021-09-26,2021-12-06,2022-05-06,16128,7232,8896
502477,Company_228,2021-08-03,2021-10-18,2022-01-28,23373,18743,4630
502478,Company_228,2020-02-06,2020-03-19,2020-09-10,20277,11330,8947
502479,Company_228,2021-08-16,2021-10-14,2022-01-31,13850,6043,7807
502480,Company_228,2021-01-30,2021-03-28,2021-04-28,15902,10893,5009
502481,Company_228,2023-01-21,2023-04-10,2023-05-14,24985,23156,1829
502482,Company_228,2022-03-30,2022-07-01,2022-09-16,8458,3293,5165
502483,Company_228,2020-10-13,2020-11-11,2021-02-26,23366,3218,20148
502484,Company_228,2020-04-26,2020-08-20,2021-01-19,16097,9237,6860
502485,Company_228,2023-01-18,2023-02-14,2023-07-01,24103,8414,15689
502486,Company_228,2022-09-15,2022-12-19,2022-12-20,21320,7039,14281
502487,Company_228,2022-09-05,2022-09-22,2022-11-26,6606,3132,3474
502488,Company_228,2022-04-28,2022-06-16,2022-08-06,1738,1330,408
502489,Company_229,2022-12-16,2023-01-10,2023-02-16,14564,10672,3892
502490,Company_229,2022-06-05,2022-09-16,2022-09-24,13832,13730,102
502491,Company_229,2023-03-20,2023-07-09,2023-11-14,13651,11447,2204
502492,Company_229,2023-07-29,2023-09-22,2023-11-07,1335,1290,45
502493,Company_229,2023-04-21,2023-07-04,2023-07-14,4936,2459,2477
502494,Company_229,2022-07-23,2022-09-17,2022-10-15,18573,1312,17261
502495,Company_229,2021-02-21,2021-03-16,2021-05-25,15670,10393,5277
502496,Company_229,2023-12-01,2024-01-25,2024-03-12,6653,2606,4047
502497,Company_229,2022-12-23,2023-03-07,2023-06-11,19349,1246,18103
502498,Company_229,2022-12-19,2023-02-18,2023-03-17,23473,23413,60
502499,Company_229,2020-11-01,2020-12-05,2021-01-15,11847,4840,7007
502500,Company_229,2020-11-29,2021-02-20,2021-07-08,831,453,378
502501,Company_229,2020-07-08,2020-07-30,2020-10-30,9846,1595,8251
502502,Company_229,2023-06-14,2023-09-09,2024-02-14,9289,1108,8181
502503,Company_229,2022-06-15,2022-07-23,2022-12-24,11183,2189,8994
502504,Company_229,2021-01-24,2021-02-22,2021-09-03,12989,5933,7056
502505,Company_229,2022-11-06,2023-01-03,2023-01-10,13219,8285,4934
502506,Company_230,2020-02-12,2020-05-16,2020-07-19,19005,82,18923
502507,Company_230,2023-01-01,2023-04-21,2023-10-21,18533,12762,5771
502508,Company_230,2022-08-04,2022-09-07,2022-10-12,18218,14725,3493
502509,Company_230,2020-07-31,2020-09-08,2020-12-23,4192,1539,2653
502510,Company_230,2023-02-23,2023-03-24,2023-05-20,24167,9920,14247
502511,Company_230,2021-02-13,2021-05-03,2021-05-10,7309,4669,2640
502512,Company_230,2020-02-21,2020-03-29,2020-09-26,2607,793,1814
502513,Company_230,2020-11-16,2021-01-26,2021-06-14,5284,3497,1787
502514,Company_230,2023-12-15,2024-03-09,2024-04-04,6926,6639,287
502515,Company_230,2022-07-09,2022-10-12,2023-04-23,11816,8487,3329
502516,Company_230,2020-12-12,2021-02-08,2021-05-17,3331,1732,1599
502517,Company_230,2023-09-24,2023-12-20,2024-02-01,4575,3622,953
502518,Company_230,2022-01-13,2022-04-29,2022-05-29,12690,2242,10448
502519,Company_230,2021-12-01,2022-01-09,2022-02-24,1485,1046,439
502520,Company_230,2021-01-29,2021-05-10,2021-08-13,23508,6931,16577
502521,Company_230,2022-12-20,2023-02-20,2023-09-02,2539,2266,273
502522,Company_231,2020-02-25,2020-05-14,2020-11-06,21209,4253,16956
502523,Company_231,2023-08-06,2023-10-21,2024-04-23,7768,3141,4627
502524,Company_231,2023-06-18,2023-08-24,2023-11-08,16518,7501,9017
502525,Company_231,2023-07-01,2023-08-25,2023-09-15,17255,3047,14208
502526,Company_231,2022-08-14,2022-09-08,2023-03-08,11752,6595,5157
502527,Company_231,2020-06-12,2020-07-26,2020-08-31,13142,9469,3673
502528,Company_231,2020-07-12,2020-11-06,2020-11-22,11966,10315,1651
502529,Company_231,2024-02-02,2024-03-06,2024-04-22,7614,3010,4604
502530,Company_231,2020-10-19,2020-11-10,2021-05-06,22592,10912,11680
502531,Company_231,2021-07-22,2021-10-05,2021-11-27,5439,4389,1050
502532,Company_231,2022-11-13,2022-12-24,2023-01-09,13648,3274,10374
502533,Company_231,2023-11-30,2023-12-21,2024-02-13,23877,17633,6244
502534,Company_231,2023-03-06,2023-05-16,2023-06-12,20835,18740,2095
502535,Company_231,2020-01-21,2020-04-25,2020-09-06,5489,84,5405
502536,Company_231,2022-01-10,2022-04-19,2022-08-25,20381,9955,10426
502537,Company_231,2021-11-14,2021-12-12,2022-05-10,21297,13712,7585
502538,Company_231,2021-07-02,2021-10-04,2022-03-05,15698,6349,9349
502539,Company_231,2023-03-09,2023-04-14,2023-05-18,4314,2328,1986
502540,Company_232,2023-08-22,2023-10-25,2024-04-27,3360,1285,2075
502541,Company_232,2021-09-02,2021-10-31,2021-11-28,5060,1331,3729
502542,Company_232,2023-02-05,2023-04-11,2023-08-29,3000,1511,1489
502543,Company_232,2024-01-11,2024-03-13,2024-05-22,23766,23512,254
502544,Company_232,2023-09-15,2023-10-16,2024-02-29,15769,2269,13500
502545,Company_232,2022-02-25,2022-04-11,2022-10-05,22396,10389,12007
502546,Company_232,2021-06-05,2021-09-16,2021-12-20,8171,3321,4850
502547,Company_232,2023-07-16,2023-10-09,2024-04-11,3105,961,2144
502548,Company_232,2023-07-07,2023-11-02,2024-03-06,14789,7115,7674
502549,Company_232,2020-10-04,2021-01-13,2021-07-10,6193,4856,1337
502550,Company_232,2022-05-25,2022-07-18,2022-08-13,7849,4036,3813
502551,Company_232,2022-04-29,2022-07-14,2022-12-31,1238,901,337
502552,Company_232,2021-04-26,2021-06-06,2021-11-08,21714,10459,11255
502553,Company_233,2022-06-17,2022-09-22,2022-12-01,12098,10674,1424
502554,Company_233,2023-09-25,2023-11-27,2024-03-21,8660,4384,4276
502555,Company_234,2023-12-20,2024-04-15,2024-08-27,11528,2694,8834
502556,Company_234,2021-06-01,2021-09-11,2022-01-28,12646,2901,9745
502557,Company_234,2022-01-28,2022-04-08,2022-05-05,1495,1450,45
502558,Company_234,2023-12-25,2024-01-21,2024-03-27,2812,1010,1802
502559,Company_234,2020-12-19,2021-03-19,2021-07-24,2362,2104,258
502560,Company_234,2020-04-13,2020-07-27,2020-08-23,3686,2120,1566
502561,Company_234,2023-10-01,2023-11-21,2023-12-20,15647,9451,6196
502562,Company_234,2021-06-19,2021-08-17,2022-02-24,1778,117,1661
502563,Company_234,2021-06-09,2021-09-09,2021-11-24,10394,6364,4030
502564,Company_234,2021-01-28,2021-04-29,2021-08-08,6992,4261,2731
502565,Company_234,2021-05-13,2021-08-30,2021-10-07,10742,7908,2834
502566,Company_234,2023-06-05,2023-08-11,2023-10-18,11160,5401,5759
502567,Company_234,2021-03-10,2021-05-19,2021-08-06,11312,9123,2189
502568,Company_234,2022-07-22,2022-09-26,2022-12-05,21767,1580,20187
502569,Company_234,2020-01-21,2020-02-05,2020-04-26,8964,4675,4289
502570,Company_234,2022-07-18,2022-08-19,2022-12-20,14293,761,13532
502571,Company_234,2022-04-02,2022-05-03,2022-08-25,9303,5925,3378
502572,Company_234,2023-09-09,2023-12-12,2024-03-28,22790,16396,6394
502573,Company_234,2020-10-26,2020-11-15,2021-02-17,8059,3200,4859
502574,Company_235,2021-04-28,2021-08-25,2021-11-04,8863,590,8273
502575,Company_235,2021-08-25,2021-11-15,2021-12-25,5009,931,4078
502576,Company_235,2023-03-05,2023-05-29,2023-10-14,9037,7674,1363
502577,Company_235,2021-10-28,2022-01-07,2022-03-12,16897,1673,15224
502578,Company_235,2021-08-09,2021-11-09,2021-12-30,12043,11544,499
502579,Company_235,2020-07-13,2020-08-03,2020-08-06,17799,2053,15746
502580,Company_235,2023-05-17,2023-08-27,2024-01-12,16860,7424,9436
502581,Company_235,2022-11-26,2023-02-04,2023-04-26,6691,4829,1862
502582,Company_235,2020-02-04,2020-05-18,2020-09-19,3124,1306,1818
502583,Company_235,2022-07-21,2022-08-27,2023-01-22,24874,7271,17603
502584,Company_235,2021-11-21,2022-03-11,2022-07-27,13815,3987,9828
502585,Company_235,2022-08-23,2022-11-02,2023-03-30,3272,935,2337
502586,Company_235,2022-12-09,2023-01-05,2023-01-12,9906,7779,2127
502587,Company_235,2021-08-23,2021-11-11,2022-04-17,19480,7936,11544
502588,Company_235,2020-02-11,2020-06-04,2020-06-08,12089,1205,10884
502589,Company_235,2023-09-04,2023-11-18,2024-02-14,18088,1325,16763
502590,Company_236,2020-12-02,2021-02-25,2021-03-01,6350,1722,4628
502591,Company_236,2023-07-26,2023-11-22,2023-11-29,4145,2996,1149
502592,Company_236,2020-04-10,2020-06-15,2020-11-13,12946,10050,2896
502593,Company_236,2023-06-21,2023-07-02,2023-12-22,16594,8217,8377
502594,Company_236,2021-04-07,2021-06-02,2021-07-23,4194,1023,3171
502595,Company_236,2021-11-10,2021-12-05,2021-12-14,4604,4009,595
502596,Company_236,2022-02-02,2022-05-09,2022-10-30,2558,1142,1416
502597,Company_236,2021-03-19,2021-06-22,2021-08-25,18285,7981,10304
502598,Company_236,2024-02-03,2024-03-17,2024-04-13,15581,424,15157
502599,Company_236,2022-06-08,2022-08-04,2022-08-17,17840,7989,9851
502600,Company_236,2020-07-11,2020-09-20,2020-11-05,12618,3444,9174
502601,Company_237,2024-01-01,2024-03-14,2024-03-29,8576,2431,6145
502602,Company_237,2022-03-29,2022-04-21,2022-08-16,5264,229,5035
502603,Company_237,2021-01-18,2021-03-07,2021-06-06,5155,4893,262
502604,Company_237,2021-03-27,2021-04-09,2021-06-17,23768,13607,10161
502605,Company_237,2021-01-29,2021-04-22,2021-07-04,13807,5234,8573
502606,Company_237,2020-05-23,2020-08-20,2021-01-16,22328,9732,12596
502607,Company_238,2022-02-08,2022-06-04,2022-06-09,23404,18043,5361
502608,Company_238,2021-09-27,2022-01-18,2022-03-05,15228,693,14535
502609,Company_238,2021-06-01,2021-09-24,2021-12-28,22934,16641,6293
502610,Company_238,2020-10-10,2020-10-28,2020-12-02,3892,1606,2286
502611,Company_238,2023-10-05,2024-01-04,2024-05-04,13522,11727,1795
502612,Company_238,2020-08-24,2020-10-14,2021-03-15,4330,3255,1075
502613,Company_238,2023-01-12,2023-02-16,2023-05-21,13774,352,13422
502614,Company_238,2021-10-13,2021-12-16,2022-03-31,11919,10297,1622
502615,Company_238,2023-07-13,2023-10-07,2023-12-13,8100,4479,3621
502616,Company_238,2020-11-05,2021-02-18,2021-04-25,16621,711,15910
502617,Company_238,2020-12-02,2021-03-26,2021-06-15,2260,1858,402
502618,Company_238,2022-05-25,2022-07-24,2023-01-05,13218,10717,2501
502619,Company_238,2021-03-08,2021-06-24,2021-06-28,12603,327,12276
502620,Company_238,2022-12-11,2023-01-10,2023-05-29,2010,1419,591
502621,Company_238,2020-12-04,2021-01-16,2021-03-20,22068,5023,17045
502622,Company_238,2020-07-31,2020-11-13,2020-11-20,7942,6294,1648
502623,Company_239,2021-10-29,2021-12-23,2022-06-26,10425,7867,2558
502624,Company_239,2023-01-05,2023-04-26,2023-10-03,6738,3427,3311
502625,Company_239,2023-02-22,2023-05-31,2023-12-02,7521,4478,3043
502626,Company_239,2021-04-20,2021-05-01,2021-11-11,22223,20098,2125
502627,Company_239,2023-07-28,2023-10-17,2024-01-09,22544,17122,5422
502628,Company_239,2023-04-04,2023-06-25,2023-11-01,4114,792,3322
502629,Company_239,2021-08-28,2021-12-07,2022-05-22,12820,10744,2076
502630,Company_239,2021-06-05,2021-06-16,2021-10-15,21781,11788,9993
502631,Company_239,2021-08-11,2021-10-22,2022-04-21,15973,3070,12903
502632,Company_239,2023-01-15,2023-05-01,2023-07-28,10687,2105,8582
502633,Company_239,2023-01-13,2023-02-03,2023-06-20,1807,731,1076
502634,Company_239,2022-06-16,2022-07-11,2022-09-29,15787,7343,8444
502635,Company_239,2020-08-17,2020-11-06,2021-05-14,22115,19529,2586
502636,Company_239,2020-07-06,2020-08-03,2020-08-10,23687,12053,11634
502637,Company_240,2023-10-25,2024-01-13,2024-01-22,4421,2416,2005
502638,Company_240,2020-04-03,2020-05-19,2020-08-01,1120,175,945
502639,Company_240,2020-05-30,2020-06-29,2020-12-14,6766,6056,710
502640,Company_240,2022-11-16,2022-12-03,2023-05-25,23834,19236,4598
502641,Company_240,2023-12-29,2024-03-20,2024-07-01,3051,2854,197
502642,Company_240,2021-09-05,2021-10-15,2022-03-31,4666,786,3880
502643,Company_240,2023-09-18,2023-11-01,2024-02-17,3625,1661,1964
502644,Company_240,2023-01-31,2023-02-25,2023-04-16,2480,1776,704
502645,Company_240,2022-10-17,2022-11-22,2023-01-21,14211,1296,12915
502646,Company_240,2020-12-22,2021-03-14,2021-06-14,3212,487,2725
502647,Company_241,2022-11-23,2023-02-07,2023-07-01,6614,2020,4594
502648,Company_241,2020-02-22,2020-03-16,2020-04-21,1341,1,1340
502649,Company_241,2023-05-22,2023-08-22,2024-01-29,2594,2068,526
502650,Company_241,2022-04-15,2022-04-30,2022-10-29,12037,10983,1054
502651,Company_241,2022-02-03,2022-05-12,2022-06-15,7479,7424,55
502652,Company_241,2023-03-14,2023-06-01,2023-09-20,19950,5523,14427
502653,Company_241,2023-09-22,2023-10-18,2024-01-31,18299,15877,2422
502654,Company_241,2022-12-06,2023-02-25,2023-08-08,1981,1678,303
502655,Company_241,2023-09-23,2024-01-09,2024-07-03,9625,992,8633
502656,Company_241,2023-11-16,2024-02-11,2024-04-23,15982,13885,2097
502657,Company_241,2023-10-20,2024-01-02,2024-05-07,3089,1433,1656
502658,Company_241,2021-02-19,2021-04-01,2021-07-10,1154,990,164
502659,Company_241,2023-08-23,2023-09-24,2024-03-04,5179,3291,1888
502660,Company_241,2023-09-01,2023-10-15,2024-03-23,4700,1945,2755
502661,Company_242,2021-03-30,2021-05-29,2021-08-29,5171,75,5096
502662,Company_242,2022-08-23,2022-11-15,2023-05-27,8332,2863,5469
502663,Company_242,2020-01-05,2020-04-24,2020-07-04,15809,7894,7915
502664,Company_242,2023-07-20,2023-07-31,2023-12-13,24915,19005,5910
502665,Company_243,2022-02-06,2022-06-01,2022-10-22,14740,5236,9504
502666,Company_243,2023-09-18,2024-01-01,2024-06-13,15172,10140,5032
502667,Company_243,2021-01-10,2021-04-25,2021-11-08,10782,5957,4825
502668,Company_243,2020-09-08,2020-11-07,2020-12-12,16234,4758,11476
502669,Company_243,2022-05-24,2022-08-25,2022-09-01,17699,16121,1578
502670,Company_243,2021-04-28,2021-07-26,2021-12-30,18688,1775,16913
502671,Company_244,2020-06-27,2020-08-20,2021-01-03,23804,5966,17838
502672,Company_244,2021-12-18,2022-03-06,2022-06-14,15363,13151,2212
502673,Company_244,2020-09-28,2021-01-02,2021-07-11,16028,12535,3493
502674,Company_244,2020-03-18,2020-04-17,2020-10-31,16702,7183,9519
502675,Company_244,2023-01-14,2023-03-07,2023-07-20,7558,1476,6082
502676,Company_244,2020-05-30,2020-09-10,2021-01-28,18200,8324,9876
502677,Company_244,2023-10-12,2023-12-13,2024-01-03,4710,4389,321
502678,Company_244,2022-01-22,2022-02-14,2022-04-12,21876,1366,20510
502679,Company_244,2020-02-14,2020-03-14,2020-05-12,14557,6693,7864
502680,Company_244,2021-12-21,2022-03-15,2022-06-20,19475,6048,13427
502681,Company_244,2022-07-21,2022-09-08,2022-10-30,1286,506,780
502682,Company_244,2022-04-08,2022-06-28,2022-07-23,5065,4101,964
502683,Company_244,2021-07-19,2021-09-07,2022-01-05,2512,2124,388
502684,Company_245,2020-11-12,2021-02-19,2021-07-30,7781,6564,1217
502685,Company_245,2023-06-24,2023-09-20,2024-03-18,17594,7331,10263
502686,Company_245,2020-01-14,2020-01-31,2020-05-31,24873,24080,793
502687,Company_245,2020-02-03,2020-04-25,2020-10-12,8714,6311,2403
502688,Company_245,2023-03-26,2023-07-06,2023-12-06,20104,19265,839
502689,Company_245,2023-06-11,2023-07-13,2023-11-08,12694,3405,9289
502690,Company_245,2021-06-26,2021-09-17,2021-10-26,12877,12662,215
502691,Company_246,2020-06-19,2020-10-14,2020-11-13,11594,10026,1568
502692,Company_246,2022-09-10,2023-01-02,2023-01-18,2680,2162,518
502693,Company_246,2021-11-09,2022-03-01,2022-06-02,3751,2913,838
502694,Company_246,2020-01-05,2020-01-19,2020-03-26,19202,15666,3536
502695,Company_246,2023-04-19,2023-08-09,2023-09-29,23228,20820,2408
502696,Company_246,2022-08-17,2022-09-26,2022-10-19,6732,3667,3065
502697,Company_246,2023-12-24,2024-04-17,2024-05-05,17124,15437,1687
502698,Company_246,2022-07-27,2022-10-12,2023-04-14,4518,781,3737
502699,Company_246,2021-12-24,2022-02-02,2022-08-13,18577,17667,910
502700,Company_247,2023-04-03,2023-06-06,2023-09-26,24048,17435,6613
502701,Company_247,2022-09-02,2022-11-01,2022-11-26,7101,736,6365
502702,Company_247,2020-07-29,2020-09-01,2020-10-23,10006,6156,3850
502703,Company_247,2020-02-01,2020-04-28,2020-06-02,17456,4806,12650
502704,Company_247,2022-05-10,2022-07-04,2022-07-18,12243,5526,6717
502705,Company_247,2020-03-09,2020-05-31,2020-10-25,18187,16070,2117
502706,Company_247,2023-06-02,2023-08-14,2023-10-14,5991,1985,4006
502707,Company_247,2022-12-13,2023-02-02,2023-07-26,7555,4298,3257
502708,Company_247,2022-03-27,2022-07-06,2022-07-11,2608,2415,193
502709,Company_247,2022-07-21,2022-08-26,2022-11-03,23458,11395,12063
502710,Company_247,2022-07-13,2022-09-10,2022-09-20,22165,5408,16757
502711,Company_247,2023-10-03,2023-11-24,2024-05-31,15667,1101,14566
502712,Company_247,2020-12-09,2021-04-02,2021-07-26,1573,365,1208
502713,Company_247,2022-09-26,2022-10-31,2023-04-28,1687,577,1110
502714,Company_247,2022-03-20,2022-06-20,2022-12-09,2121,826,1295
502715,Company_247,2021-07-22,2021-10-15,2021-10-24,8986,763,8223
502716,Company_247,2022-06-28,2022-10-14,2022-12-19,16172,418,15754
502717,Company_247,2020-08-02,2020-10-29,2020-12-06,8705,7870,835
502718,Company_247,2022-10-04,2022-12-08,2022-12-21,7835,3054,4781
502719,Company_248,2021-07-24,2021-11-07,2022-04-21,8281,1108,7173
502720,Company_248,2023-12-14,2024-03-30,2024-06-22,14159,4999,9160
502721,Company_248,2022-07-24,2022-10-24,2023-03-23,6492,1908,4584
502722,Company_248,2020-12-22,2021-03-22,2021-07-27,864,227,637
502723,Company_248,2023-08-12,2023-09-18,2024-03-26,24164,6357,17807
502724,Company_248,2022-07-07,2022-07-31,2022-10-12,9059,8817,242
502725,Company_248,2023-08-28,2023-09-23,2024-02-19,5446,405,5041
502726,Company_248,2021-01-02,2021-01-26,2021-03-27,17233,3558,13675
502727,Company_248,2021-12-27,2022-03-19,2022-09-05,9591,7954,1637
502728,Company_248,2024-01-20,2024-02-06,2024-05-22,2379,71,2308
502729,Company_248,2023-10-15,2023-12-07,2024-02-25,22279,6754,15525
502730,Company_249,2022-10-03,2022-10-28,2022-12-30,7407,4852,2555
502731,Company_249,2023-08-06,2023-10-07,2023-10-08,1853,1254,599
502732,Company_249,2022-05-27,2022-07-03,2022-07-26,21406,4514,16892
502733,Company_250,2023-09-12,2023-12-06,2024-04-01,13269,10871,2398
502734,Company_250,2020-09-29,2020-12-11,2021-03-02,10070,2359,7711
502735,Company_250,2023-03-20,2023-06-13,2023-08-06,21183,13108,8075
502736,Company_250,2021-04-17,2021-07-06,2021-09-13,7643,4362,3281
502737,Company_250,2021-01-01,2021-02-06,2021-04-03,20338,13839,6499
502738,Company_250,2021-11-24,2022-02-26,2022-07-10,18754,9036,9718
502739,Company_250,2020-01-10,2020-04-09,2020-05-24,9033,3623,5410
502740,Company_250,2020-08-20,2020-09-12,2020-12-25,13568,7051,6517
502741,Company_250,2021-12-06,2022-03-21,2022-09-05,5795,5535,260
502742,Company_250,2021-04-04,2021-07-31,2021-11-26,24448,5402,19046
502743,Company_250,2022-04-21,2022-06-11,2022-08-22,22844,8374,14470
502744,Company_250,2023-01-01,2023-03-09,2023-08-20,7174,5776,1398
502745,Company_250,2021-07-01,2021-09-07,2022-01-13,4670,896,3774
502746,Company_250,2023-06-16,2023-08-01,2023-08-09,15388,1031,14357
502747,Company_250,2023-09-11,2023-12-19,2024-07-03,21620,19441,2179
502748,Company_250,2022-08-16,2022-09-19,2023-03-16,18237,13127,5110
502749,Company_250,2020-01-09,2020-05-01,2020-09-23,9422,9178,244
