id_facture,nom_du_client,create_date,due_in_date,clear_date,montant_totale,totale_payer,totale_reste
400001,Client_1,2022-09-06,2022-11-03,2023-01-31,11235,9116,2119
400002,Client_1,2023-05-29,2023-08-12,2023-09-26,1945,220,1725
400003,Client_1,2022-11-11,2022-12-07,2023-03-21,12519,5965,6554
400004,Client_1,2021-07-17,2021-09-04,2021-11-09,4447,1128,3319
400005,Client_1,2022-06-01,2022-06-24,2022-09-17,6962,2406,4556
400006,Client_1,2021-09-30,2021-11-25,2021-12-05,15648,5618,10030
400007,Client_1,2021-02-05,2021-04-09,2021-07-27,3239,739,2500
400008,Client_1,2023-04-02,2023-05-09,2023-06-13,7340,3049,4291
400009,Client_1,2022-10-25,2023-01-22,2023-04-17,15482,6956,8526
400010,Client_1,2021-02-14,2021-04-19,2021-06-01,12159,6677,5482
400011,Client_1,2023-05-09,2023-07-25,2023-11-15,6408,6261,147
400012,Client_1,2021-09-11,2021-12-01,2022-01-20,17976,13391,4585
400013,Client_2,2023-06-20,2023-08-25,2023-11-18,6291,3002,3289
400014,Client_2,2022-09-02,2022-09-27,2022-12-27,3312,1305,2007
400015,Client_2,2021-09-18,2021-10-14,2022-01-29,11730,6917,4813
400016,Client_2,2021-05-02,2021-07-27,2021-09-27,11211,6953,4258
400017,Client_2,2023-03-23,2023-05-24,2023-06-18,4355,852,3503
400018,Client_2,2023-06-05,2023-07-07,2023-08-02,5952,1864,4088
400019,Client_3,2021-05-17,2021-07-31,2021-10-18,10494,8442,2052
400020,Client_3,2021-08-14,2021-11-08,2022-01-30,16642,916,15726
400021,Client_3,2021-12-29,2022-02-08,2022-04-12,2669,1176,1493
400022,Client_3,2023-04-11,2023-07-03,2023-08-11,6065,1009,5056
400023,Client_4,2021-04-16,2021-06-13,2021-08-13,4413,2045,2368
400024,Client_4,2023-05-05,2023-07-23,2023-08-18,740,139,601
400025,Client_4,2023-07-10,2023-08-07,2023-08-20,11178,613,10565
400026,Client_4,2022-11-22,2023-01-14,2023-02-05,2210,1679,531
400027,Client_4,2021-12-30,2022-02-12,2022-03-24,3034,533,2501
400028,Client_4,2022-07-23,2022-08-23,2022-12-20,8794,7999,795
400029,Client_4,2022-03-07,2022-04-02,2022-06-26,6710,1633,5077
400030,Client_4,2021-01-11,2021-04-02,2021-07-11,4036,444,3592
400031,Client_4,2022-05-30,2022-06-20,2022-07-09,19397,3238,16159
400032,Client_4,2023-08-03,2023-09-04,2023-11-07,6130,1882,4248
400033,Client_4,2023-05-10,2023-08-04,2023-09-05,14845,844,14001
400034,Client_4,2022-01-09,2022-02-07,2022-02-16,2755,2143,612
400035,Client_4,2021-11-28,2022-01-31,2022-03-06,8851,7083,1768
400036,Client_5,2022-08-20,2022-10-22,2022-11-16,13881,3085,10796
400037,Client_5,2023-08-23,2023-09-13,2023-12-05,11773,2181,9592
400038,Client_5,2022-06-26,2022-09-06,2022-12-07,11969,1158,10811
400039,Client_5,2023-04-22,2023-06-17,2023-10-03,5969,946,5023
400040,Client_5,2022-08-08,2022-10-15,2023-02-03,12627,2571,10056
400041,Client_6,2023-04-05,2023-05-20,2023-06-13,8408,3712,4696
400042,Client_6,2022-01-06,2022-03-27,2022-07-01,1255,722,533
400043,Client_6,2022-06-28,2022-07-27,2022-11-02,3639,647,2992
400044,Client_6,2023-08-09,2023-09-22,2023-11-21,4545,1363,3182
400045,Client_6,2022-03-06,2022-05-30,2022-09-18,19960,14735,5225
400046,Client_6,2021-06-15,2021-08-28,2021-10-30,5762,74,5688
400047,Client_6,2022-06-30,2022-07-17,2022-10-13,11449,1126,10323
400048,Client_6,2021-06-09,2021-07-14,2021-08-24,11262,1833,9429
400049,Client_6,2023-02-14,2023-04-06,2023-05-03,14885,4484,10401
400050,Client_6,2021-12-13,2022-03-08,2022-05-13,19565,14262,5303
400051,Client_6,2021-12-25,2022-02-25,2022-03-03,2884,277,2607
400052,Client_6,2022-09-11,2022-10-14,2023-02-05,1435,1101,334
400053,Client_6,2021-12-31,2022-02-05,2022-05-02,7457,4818,2639
400054,Client_6,2022-12-11,2023-01-12,2023-03-12,2254,1549,705
400055,Client_7,2022-05-27,2022-08-24,2022-10-08,17248,6123,11125
400056,Client_7,2022-05-09,2022-06-18,2022-07-27,12273,2714,9559
400057,Client_7,2021-02-04,2021-02-20,2021-04-29,10517,1823,8694
400058,Client_7,2023-06-15,2023-08-24,2023-09-16,15083,10662,4421
400059,Client_7,2021-04-24,2021-06-17,2021-08-27,5523,2523,3000
400060,Client_7,2022-01-16,2022-03-22,2022-06-11,16977,14015,2962
400061,Client_7,2022-11-20,2023-01-12,2023-05-02,5762,5032,730
400062,Client_7,2021-10-07,2021-12-25,2022-01-24,14220,12411,1809
400063,Client_7,2022-03-10,2022-03-31,2022-05-15,12265,1570,10695
400064,Client_7,2023-05-27,2023-07-10,2023-10-16,16086,14480,1606
400065,Client_7,2022-06-16,2022-08-27,2022-11-06,6061,2850,3211
400066,Client_7,2021-01-02,2021-02-12,2021-05-28,5290,118,5172
400067,Client_7,2022-08-26,2022-09-12,2022-12-17,2175,261,1914
400068,Client_7,2021-01-27,2021-03-28,2021-07-24,2546,383,2163
400069,Client_8,2021-03-24,2021-05-18,2021-06-10,16661,6247,10414
400070,Client_8,2022-07-19,2022-08-20,2022-09-16,12822,11525,1297
400071,Client_8,2021-06-30,2021-08-16,2021-11-22,2984,462,2522
400072,Client_8,2022-11-06,2023-01-13,2023-02-22,14971,14146,825
400073,Client_8,2022-08-09,2022-09-07,2022-12-28,5996,1249,4747
400074,Client_8,2021-05-11,2021-07-30,2021-11-16,3893,1801,2092
400075,Client_8,2022-01-31,2022-03-27,2022-05-10,5956,5043,913
400076,Client_9,2021-01-22,2021-04-03,2021-04-20,8617,3717,4900
400077,Client_9,2022-05-08,2022-05-26,2022-06-30,4313,4271,42
400078,Client_9,2023-06-05,2023-07-04,2023-10-10,4166,2056,2110
400079,Client_9,2021-08-20,2021-10-17,2022-02-08,7527,5347,2180
400080,Client_9,2022-09-28,2022-12-24,2023-03-12,11056,2946,8110
400081,Client_9,2022-12-17,2023-03-04,2023-05-23,8471,7370,1101
400082,Client_10,2022-06-20,2022-07-19,2022-10-30,8547,7311,1236
400083,Client_10,2023-03-28,2023-05-23,2023-07-27,10649,2983,7666
400084,Client_11,2021-08-16,2021-09-23,2021-10-22,4285,3939,346
400085,Client_12,2021-07-29,2021-10-13,2021-10-27,6596,4467,2129
400086,Client_12,2022-09-01,2022-10-05,2022-12-03,17687,6277,11410
400087,Client_12,2021-10-12,2021-11-20,2022-01-20,11488,5287,6201
400088,Client_12,2021-02-23,2021-04-29,2021-08-19,10857,10380,477
400089,Client_12,2021-09-25,2021-10-14,2021-10-21,9971,6616,3355
400090,Client_12,2023-07-17,2023-09-26,2023-10-29,9572,4406,5166
400091,Client_12,2022-06-08,2022-07-20,2022-09-02,7140,6010,1130
400092,Client_13,2022-07-29,2022-08-31,2022-12-13,2570,293,2277
400093,Client_13,2022-03-13,2022-04-09,2022-05-08,14119,2029,12090
400094,Client_13,2022-09-22,2022-11-26,2023-01-25,16905,2597,14308
400095,Client_13,2023-03-03,2023-04-08,2023-06-19,9479,8303,1176
400096,Client_13,2023-04-15,2023-05-10,2023-07-01,5265,2909,2356
400097,Client_13,2023-01-13,2023-04-04,2023-04-28,17437,5818,11619
400098,Client_14,2022-09-23,2022-12-10,2023-02-21,10274,5715,4559
400099,Client_15,2023-02-15,2023-04-02,2023-05-18,6211,334,5877
400100,Client_15,2021-09-18,2021-10-20,2021-10-28,6988,760,6228
400101,Client_15,2022-09-06,2022-10-18,2022-12-13,8313,2753,5560
400102,Client_15,2022-02-25,2022-04-15,2022-07-29,1571,430,1141
400103,Client_16,2023-04-04,2023-06-20,2023-08-24,18705,4587,14118
400104,Client_16,2021-08-16,2021-10-30,2021-11-16,8508,1014,7494
400105,Client_16,2022-08-11,2022-10-19,2023-02-12,18304,2311,15993
400106,Client_16,2021-04-15,2021-07-11,2021-08-18,15056,3955,11101
400107,Client_16,2021-08-19,2021-09-06,2021-11-08,7070,1661,5409
400108,Client_16,2021-11-07,2022-01-05,2022-03-14,6258,2659,3599
400109,Client_16,2023-04-13,2023-05-29,2023-07-16,11544,2145,9399
400110,Client_17,2022-10-25,2022-12-23,2023-01-22,19133,9098,10035
400111,Client_17,2021-09-11,2021-10-18,2022-01-28,19357,11704,7653
400112,Client_17,2023-07-27,2023-09-15,2023-11-03,19965,12805,7160
400113,Client_17,2022-05-19,2022-06-05,2022-06-29,11291,487,10804
400114,Client_17,2023-03-12,2023-04-21,2023-07-31,1772,172,1600
400115,Client_17,2022-12-02,2023-01-07,2023-02-10,5363,2037,3326
400116,Client_17,2023-02-27,2023-05-06,2023-08-12,6322,5767,555
400117,Client_18,2021-08-08,2021-11-04,2022-01-05,10428,9453,975
400118,Client_18,2022-03-31,2022-05-02,2022-05-09,14064,10843,3221
400119,Client_18,2022-07-18,2022-09-05,2022-12-04,9899,9509,390
400120,Client_18,2021-08-01,2021-10-10,2022-01-06,9301,1257,8044
400121,Client_18,2023-06-04,2023-07-20,2023-08-19,13082,4242,8840
400122,Client_18,2022-12-06,2023-01-19,2023-03-20,6497,3259,3238
400123,Client_18,2021-11-23,2022-02-11,2022-05-23,2269,305,1964
400124,Client_18,2022-08-03,2022-09-01,2022-11-06,6938,3121,3817
400125,Client_18,2021-06-01,2021-08-27,2021-11-05,12906,2558,10348
400126,Client_18,2022-12-22,2023-01-12,2023-05-01,19430,7334,12096
400127,Client_18,2023-09-25,2023-10-15,2023-11-10,11998,349,11649
400128,Client_18,2021-02-21,2021-04-13,2021-07-07,14237,9725,4512
400129,Client_19,2021-12-01,2022-02-27,2022-06-19,2736,121,2615
400130,Client_19,2021-11-25,2022-02-06,2022-04-12,7058,1496,5562
400131,Client_19,2021-10-20,2022-01-07,2022-04-05,11359,8990,2369
400132,Client_19,2022-07-06,2022-08-14,2022-12-02,4446,2282,2164
400133,Client_19,2022-02-14,2022-05-12,2022-07-22,17092,229,16863
400134,Client_19,2021-01-10,2021-02-27,2021-04-09,2377,495,1882
400135,Client_19,2021-01-23,2021-02-07,2021-04-06,10622,6147,4475
400136,Client_19,2021-01-31,2021-02-20,2021-04-23,8746,3960,4786
400137,Client_19,2022-02-18,2022-04-23,2022-06-29,15637,6441,9196
400138,Client_19,2022-12-31,2023-02-23,2023-06-22,14677,12098,2579
400139,Client_19,2021-06-29,2021-07-15,2021-10-25,551,475,76
400140,Client_20,2023-03-15,2023-05-13,2023-07-29,17985,12729,5256
400141,Client_20,2022-07-30,2022-09-23,2022-09-28,12188,11761,427
400142,Client_20,2023-09-06,2023-10-11,2024-01-27,19792,8514,11278
400143,Client_20,2022-01-24,2022-03-11,2022-05-06,6229,5686,543
400144,Client_20,2021-04-07,2021-06-05,2021-07-26,18206,882,17324
400145,Client_20,2023-09-08,2023-11-10,2024-01-22,7381,1259,6122
400146,Client_20,2021-11-05,2021-12-23,2022-01-05,19517,8795,10722
400147,Client_20,2023-06-04,2023-08-28,2023-09-02,6232,6183,49
400148,Client_20,2022-05-06,2022-05-30,2022-08-30,19648,1312,18336
400149,Client_20,2022-11-05,2023-01-18,2023-03-11,16833,6706,10127
400150,Client_20,2022-10-31,2023-01-26,2023-05-10,17871,13320,4551
400151,Client_21,2023-03-09,2023-05-31,2023-07-03,14736,13346,1390
400152,Client_21,2023-04-13,2023-05-31,2023-08-26,7297,5823,1474
400153,Client_21,2021-10-14,2021-12-19,2022-01-23,8111,3652,4459
400154,Client_21,2022-03-30,2022-04-27,2022-07-02,4172,2782,1390
400155,Client_21,2022-03-11,2022-04-10,2022-07-18,13688,12510,1178
400156,Client_21,2022-06-16,2022-07-23,2022-11-09,16595,6911,9684
400157,Client_21,2022-07-08,2022-09-16,2022-09-29,14284,14238,46
400158,Client_21,2022-07-08,2022-10-03,2022-10-31,2450,1269,1181
400159,Client_21,2022-03-09,2022-05-25,2022-08-03,7950,3663,4287
400160,Client_21,2023-08-30,2023-10-02,2024-01-27,8853,2549,6304
400161,Client_21,2022-07-25,2022-09-15,2022-12-19,11435,8503,2932
400162,Client_21,2021-06-02,2021-08-21,2021-09-03,14239,8647,5592
400163,Client_21,2022-10-11,2022-12-12,2022-12-30,14980,13535,1445
400164,Client_22,2022-02-20,2022-04-04,2022-07-01,14913,13202,1711
400165,Client_22,2022-08-13,2022-09-21,2022-12-31,13719,625,13094
400166,Client_22,2023-01-05,2023-04-03,2023-06-20,8114,5179,2935
400167,Client_23,2022-08-31,2022-10-19,2022-12-15,1131,100,1031
400168,Client_23,2022-11-02,2023-01-24,2023-03-03,19279,13188,6091
400169,Client_24,2021-01-28,2021-03-17,2021-05-23,2219,115,2104
400170,Client_24,2022-08-25,2022-09-18,2022-12-08,18610,15264,3346
400171,Client_24,2021-04-17,2021-06-02,2021-09-17,12973,11962,1011
400172,Client_24,2021-02-10,2021-05-06,2021-06-21,5559,2679,2880
400173,Client_25,2022-03-15,2022-04-28,2022-08-03,1981,1433,548
400174,Client_25,2023-09-21,2023-12-13,2024-03-29,8953,429,8524
400175,Client_25,2023-07-19,2023-08-05,2023-11-13,7573,1534,6039
400176,Client_25,2022-04-25,2022-06-09,2022-07-20,1525,403,1122
400177,Client_25,2022-12-28,2023-03-13,2023-07-06,11715,6037,5678
400178,Client_25,2023-09-01,2023-09-28,2024-01-19,6617,3935,2682
400179,Client_26,2021-08-28,2021-09-12,2021-12-15,18920,12543,6377
400180,Client_26,2022-01-20,2022-03-13,2022-05-10,12281,6053,6228
400181,Client_26,2022-09-26,2022-11-20,2023-02-13,11212,1168,10044
400182,Client_26,2022-04-10,2022-07-03,2022-09-21,9968,6333,3635
400183,Client_26,2023-02-12,2023-03-17,2023-07-14,6765,2222,4543
400184,Client_26,2023-05-15,2023-07-27,2023-10-29,6611,3136,3475
400185,Client_26,2022-04-15,2022-06-13,2022-09-22,13978,13239,739
400186,Client_26,2023-08-24,2023-11-05,2024-02-18,12707,7050,5657
400187,Client_26,2022-07-31,2022-09-01,2022-09-08,9357,3156,6201
400188,Client_26,2022-11-28,2023-02-21,2023-05-06,10598,7835,2763
400189,Client_26,2021-02-24,2021-03-31,2021-07-18,14043,9961,4082
400190,Client_26,2022-02-07,2022-04-15,2022-04-23,7190,6341,849
400191,Client_27,2022-01-21,2022-02-14,2022-03-12,6886,5718,1168
400192,Client_27,2023-02-15,2023-04-17,2023-05-03,5446,2979,2467
400193,Client_27,2023-07-05,2023-08-06,2023-10-31,6406,187,6219
400194,Client_27,2021-11-05,2021-12-16,2022-03-21,12222,3858,8364
400195,Client_27,2022-12-14,2023-02-07,2023-05-13,3851,109,3742
400196,Client_28,2023-07-07,2023-08-20,2023-11-27,8510,5637,2873
400197,Client_28,2023-03-06,2023-04-16,2023-06-22,11632,2460,9172
400198,Client_29,2022-09-05,2022-12-03,2023-01-29,10125,6240,3885
400199,Client_29,2022-06-08,2022-07-19,2022-08-13,14542,6066,8476
400200,Client_29,2023-03-10,2023-03-25,2023-05-04,17528,6298,11230
400201,Client_29,2021-09-07,2021-11-18,2022-03-15,6280,3115,3165
400202,Client_29,2022-01-21,2022-02-28,2022-03-11,11323,1175,10148
400203,Client_29,2021-07-02,2021-07-17,2021-11-07,644,434,210
400204,Client_29,2023-05-08,2023-06-17,2023-07-20,13657,8188,5469
400205,Client_29,2022-04-19,2022-05-29,2022-06-08,16988,3049,13939
400206,Client_29,2023-02-08,2023-04-27,2023-08-23,10167,1704,8463
400207,Client_29,2021-06-11,2021-07-17,2021-10-22,19768,17395,2373
400208,Client_29,2022-06-04,2022-06-23,2022-06-28,13632,4307,9325
400209,Client_29,2021-01-13,2021-02-27,2021-04-09,13648,5475,8173
400210,Client_30,2023-04-05,2023-05-15,2023-09-11,7693,4627,3066
400211,Client_30,2023-03-27,2023-06-18,2023-07-26,1512,67,1445
400212,Client_31,2022-07-11,2022-10-02,2022-11-05,1712,875,837
400213,Client_31,2022-08-23,2022-10-25,2022-10-27,4718,2289,2429
400214,Client_31,2023-03-12,2023-04-29,2023-07-18,7731,1574,6157
400215,Client_31,2021-04-14,2021-05-31,2021-09-18,14207,8136,6071
400216,Client_31,2023-03-16,2023-05-08,2023-08-14,1101,949,152
400217,Client_32,2021-03-30,2021-06-27,2021-10-17,11784,8738,3046
400218,Client_32,2021-07-06,2021-09-18,2021-10-31,12548,954,11594
400219,Client_32,2023-09-19,2023-12-04,2024-03-15,11984,2115,9869
400220,Client_32,2023-07-18,2023-09-22,2023-10-31,10495,7148,3347
400221,Client_32,2022-07-24,2022-09-01,2022-09-23,1422,210,1212
400222,Client_32,2022-06-11,2022-09-02,2022-09-04,14957,6851,8106
400223,Client_32,2021-03-10,2021-05-05,2021-05-20,554,524,30
400224,Client_32,2021-09-13,2021-12-08,2022-03-05,10060,7899,2161
400225,Client_32,2023-05-03,2023-06-12,2023-09-17,5486,3817,1669
400226,Client_33,2023-09-01,2023-10-26,2023-11-21,19756,15859,3897
400227,Client_33,2022-10-27,2022-12-26,2023-01-04,4866,2685,2181
400228,Client_33,2022-09-03,2022-12-01,2022-12-12,6854,583,6271
400229,Client_33,2022-04-05,2022-07-03,2022-07-30,13493,12219,1274
400230,Client_33,2023-09-23,2023-12-04,2024-03-18,18936,1632,17304
400231,Client_33,2022-11-11,2022-11-29,2023-02-27,19959,14376,5583
400232,Client_33,2023-07-13,2023-08-06,2023-12-01,8058,6321,1737
400233,Client_33,2022-08-12,2022-09-16,2022-09-27,15447,7383,8064
400234,Client_33,2021-09-04,2021-10-06,2021-11-11,13459,10177,3282
400235,Client_33,2023-09-22,2023-11-29,2023-12-20,16356,2856,13500
400236,Client_34,2022-01-21,2022-03-28,2022-05-28,17482,8471,9011
400237,Client_35,2022-06-25,2022-08-15,2022-09-17,3841,2327,1514
400238,Client_35,2021-12-23,2022-01-31,2022-04-19,6936,6055,881
400239,Client_35,2022-01-29,2022-04-01,2022-07-09,1994,601,1393
400240,Client_36,2023-07-10,2023-07-25,2023-09-15,6660,1922,4738
400241,Client_37,2022-03-13,2022-04-06,2022-06-25,8776,8550,226
400242,Client_38,2023-04-06,2023-05-12,2023-06-10,946,732,214
400243,Client_38,2022-06-23,2022-09-18,2022-11-06,8931,8282,649
400244,Client_38,2021-03-10,2021-05-29,2021-07-30,19199,13643,5556
400245,Client_38,2023-07-29,2023-08-22,2023-11-28,7320,5497,1823
400246,Client_38,2022-09-05,2022-11-23,2023-01-08,13205,3093,10112
400247,Client_38,2021-12-29,2022-03-25,2022-07-08,18475,14644,3831
400248,Client_38,2023-03-07,2023-05-23,2023-07-08,888,127,761
400249,Client_38,2021-08-31,2021-10-17,2022-02-04,3253,634,2619
400250,Client_38,2021-11-18,2022-01-14,2022-03-29,17964,8070,9894
400251,Client_39,2022-03-21,2022-04-30,2022-05-15,5490,4067,1423
400252,Client_39,2021-07-05,2021-09-15,2021-10-20,17204,8310,8894
400253,Client_39,2021-10-14,2021-12-04,2022-02-26,17353,12411,4942
400254,Client_39,2021-12-22,2022-01-20,2022-01-29,19992,18498,1494
400255,Client_39,2021-01-28,2021-04-10,2021-04-21,18705,15194,3511
400256,Client_39,2022-06-26,2022-08-05,2022-11-03,19947,4111,15836
400257,Client_39,2022-02-18,2022-04-20,2022-05-08,2044,240,1804
400258,Client_39,2021-08-07,2021-10-07,2021-11-13,16604,418,16186
400259,Client_40,2022-07-28,2022-10-15,2022-12-16,17682,11909,5773
400260,Client_41,2023-01-24,2023-02-17,2023-04-09,12260,10075,2185
400261,Client_41,2022-05-20,2022-06-20,2022-08-09,9193,3865,5328
400262,Client_41,2022-09-03,2022-11-07,2023-01-23,16468,4739,11729
400263,Client_41,2022-05-29,2022-06-13,2022-08-29,12467,11285,1182
400264,Client_41,2022-08-08,2022-11-04,2022-11-11,5840,751,5089
400265,Client_41,2023-03-19,2023-05-22,2023-08-12,7469,4984,2485
400266,Client_41,2022-10-16,2023-01-08,2023-03-21,12273,1585,10688
400267,Client_41,2023-06-17,2023-08-08,2023-09-28,3133,2840,293
400268,Client_41,2022-04-03,2022-06-05,2022-09-06,7151,1784,5367
400269,Client_41,2022-04-06,2022-06-08,2022-08-30,1382,143,1239
400270,Client_41,2022-08-19,2022-10-19,2022-10-27,17368,5542,11826
400271,Client_41,2021-04-13,2021-05-19,2021-06-11,966,779,187
400272,Client_42,2022-12-23,2023-02-07,2023-04-02,13877,3031,10846
400273,Client_42,2022-12-24,2023-02-08,2023-03-14,18928,15806,3122
400274,Client_42,2022-07-06,2022-08-03,2022-11-25,15859,3492,12367
400275,Client_42,2021-04-28,2021-06-29,2021-08-13,18163,14415,3748
400276,Client_42,2023-03-10,2023-05-27,2023-09-07,1890,359,1531
400277,Client_42,2022-08-11,2022-10-05,2022-11-02,9489,8496,993
400278,Client_42,2021-08-26,2021-11-13,2021-12-11,17527,9882,7645
400279,Client_42,2022-07-28,2022-09-26,2022-12-04,5824,5635,189
400280,Client_42,2022-10-26,2022-11-22,2023-02-11,4447,485,3962
400281,Client_42,2023-08-06,2023-09-11,2023-11-07,6573,6360,213
400282,Client_43,2021-11-22,2021-12-12,2022-02-04,7678,1278,6400
400283,Client_43,2021-07-19,2021-09-01,2021-09-21,11305,3090,8215
400284,Client_43,2022-04-20,2022-06-16,2022-09-30,11106,4988,6118
400285,Client_43,2023-06-08,2023-07-29,2023-11-08,1933,1182,751
400286,Client_43,2022-02-20,2022-05-14,2022-06-27,9360,1339,8021
400287,Client_43,2023-01-03,2023-03-08,2023-04-06,5594,5548,46
400288,Client_43,2021-01-07,2021-02-03,2021-04-30,14911,11797,3114
400289,Client_44,2023-08-07,2023-10-17,2023-11-03,5169,5080,89
400290,Client_44,2021-11-12,2022-01-10,2022-03-15,15322,10629,4693
400291,Client_44,2022-06-09,2022-07-30,2022-10-05,12178,8480,3698
400292,Client_44,2022-11-03,2022-12-08,2023-01-21,17881,12933,4948
400293,Client_44,2021-12-04,2022-03-01,2022-06-28,1600,350,1250
400294,Client_44,2022-05-29,2022-08-01,2022-10-14,13448,10416,3032
400295,Client_44,2022-01-09,2022-02-18,2022-03-11,19679,10839,8840
400296,Client_45,2022-12-29,2023-03-22,2023-03-23,13265,10554,2711
400297,Client_45,2023-05-02,2023-06-09,2023-06-09,19851,13142,6709
400298,Client_45,2021-08-13,2021-09-08,2021-12-11,18913,17698,1215
400299,Client_46,2022-03-29,2022-05-01,2022-06-21,4523,4147,376
400300,Client_46,2022-01-18,2022-02-28,2022-03-07,9778,3289,6489
400301,Client_46,2023-07-13,2023-10-07,2023-12-01,11634,4336,7298
400302,Client_46,2021-09-22,2021-10-29,2022-01-29,17649,5647,12002
400303,Client_46,2021-07-30,2021-08-28,2021-10-25,5226,642,4584
400304,Client_46,2023-08-04,2023-08-31,2023-10-16,4297,3421,876
400305,Client_46,2021-05-02,2021-05-22,2021-05-24,14002,8999,5003
400306,Client_46,2021-03-23,2021-04-15,2021-04-21,17743,5863,11880
400307,Client_46,2021-12-26,2022-03-04,2022-04-17,14796,10163,4633
400308,Client_46,2021-03-18,2021-04-07,2021-05-09,17562,16126,1436
400309,Client_47,2023-02-21,2023-03-30,2023-06-05,3632,2627,1005
400310,Client_47,2023-01-17,2023-02-16,2023-04-05,13992,8043,5949
400311,Client_47,2021-11-28,2022-01-04,2022-02-07,9897,2464,7433
400312,Client_47,2023-06-17,2023-07-15,2023-09-01,3623,3135,488
400313,Client_47,2023-09-18,2023-10-11,2023-11-10,3844,670,3174
400314,Client_47,2021-02-03,2021-03-06,2021-05-04,13156,2711,10445
400315,Client_47,2023-05-24,2023-07-13,2023-10-18,9670,4853,4817
400316,Client_47,2023-05-16,2023-07-15,2023-08-26,18708,5626,13082
400317,Client_47,2022-09-17,2022-11-14,2023-01-30,16585,12256,4329
400318,Client_47,2021-11-08,2021-12-25,2022-04-14,15377,12888,2489
400319,Client_47,2021-06-10,2021-06-26,2021-08-30,16939,12685,4254
400320,Client_47,2022-01-01,2022-01-18,2022-03-02,5091,4508,583
400321,Client_48,2022-02-27,2022-03-23,2022-06-12,2648,2016,632
400322,Client_48,2022-04-07,2022-06-17,2022-06-17,1894,1052,842
400323,Client_48,2023-05-26,2023-07-29,2023-10-07,12670,817,11853
400324,Client_48,2023-04-11,2023-05-11,2023-05-18,14276,13370,906
400325,Client_48,2022-02-21,2022-04-29,2022-06-18,18182,8054,10128
400326,Client_48,2023-07-08,2023-09-25,2023-10-20,13206,5470,7736
400327,Client_48,2023-02-22,2023-03-14,2023-03-25,18644,12121,6523
400328,Client_48,2021-01-18,2021-02-08,2021-03-15,6366,4634,1732
400329,Client_49,2021-06-27,2021-09-02,2021-09-17,10814,9345,1469
400330,Client_49,2021-07-24,2021-09-24,2021-10-24,13673,9481,4192
400331,Client_49,2023-09-17,2023-12-03,2024-03-14,12613,4133,8480
400332,Client_49,2023-04-13,2023-06-27,2023-08-20,15472,6250,9222
400333,Client_49,2023-07-17,2023-08-24,2023-10-26,3598,624,2974
400334,Client_49,2023-06-08,2023-07-06,2023-09-27,12351,5043,7308
400335,Client_49,2023-04-15,2023-05-06,2023-05-12,9097,1281,7816
400336,Client_49,2021-07-10,2021-09-06,2021-12-01,11454,5919,5535
400337,Client_49,2021-08-30,2021-10-26,2021-11-20,11839,11151,688
400338,Client_50,2022-04-24,2022-06-14,2022-08-09,10189,6925,3264
400339,Client_50,2021-01-30,2021-04-12,2021-06-29,822,798,24
400340,Client_50,2023-06-08,2023-08-27,2023-11-25,17047,7805,9242
400341,Client_50,2022-06-12,2022-07-19,2022-09-04,7902,1942,5960
400342,Client_50,2022-01-28,2022-03-11,2022-05-02,11793,4031,7762
400343,Client_50,2022-01-30,2022-03-10,2022-05-30,15628,14489,1139
400344,Client_50,2023-06-02,2023-07-21,2023-08-18,10781,7294,3487
400345,Client_50,2023-04-28,2023-07-16,2023-07-18,13290,9352,3938
400346,Client_50,2022-03-06,2022-05-27,2022-08-23,5089,295,4794
400347,Client_50,2023-04-28,2023-05-19,2023-08-15,1823,1662,161
400348,Client_50,2021-02-22,2021-05-14,2021-06-21,16617,15712,905
400349,Client_51,2021-07-24,2021-08-23,2021-11-12,4953,1093,3860
400350,Client_51,2022-04-29,2022-06-11,2022-08-14,2390,633,1757
400351,Client_51,2021-12-12,2022-02-02,2022-05-24,8677,5693,2984
400352,Client_51,2022-08-09,2022-10-02,2022-10-19,17295,10921,6374
400353,Client_52,2023-01-16,2023-04-04,2023-07-29,14563,10751,3812
400354,Client_52,2022-02-04,2022-03-09,2022-03-21,9616,3424,6192
400355,Client_52,2023-03-20,2023-06-17,2023-10-12,15146,7500,7646
400356,Client_52,2023-01-30,2023-04-26,2023-06-23,7746,4193,3553
400357,Client_52,2021-02-24,2021-03-21,2021-05-09,7548,6318,1230
400358,Client_53,2021-06-12,2021-07-29,2021-08-23,17834,5252,12582
400359,Client_53,2021-04-06,2021-05-05,2021-06-09,2068,1569,499
400360,Client_53,2022-06-14,2022-08-28,2022-10-28,16933,7458,9475
400361,Client_53,2023-06-21,2023-09-17,2023-12-05,9395,1981,7414
400362,Client_53,2021-10-14,2021-11-14,2021-11-25,4514,1617,2897
400363,Client_53,2021-10-29,2022-01-15,2022-05-04,2029,47,1982
400364,Client_53,2021-02-20,2021-04-02,2021-06-22,769,101,668
400365,Client_53,2021-05-03,2021-06-26,2021-06-27,6668,4,6664
400366,Client_53,2021-01-23,2021-03-08,2021-03-09,16905,9847,7058
400367,Client_53,2022-08-05,2022-10-09,2022-10-26,19981,1995,17986
400368,Client_53,2021-05-13,2021-06-17,2021-09-12,19161,256,18905
400369,Client_53,2022-05-27,2022-07-22,2022-09-11,9072,3357,5715
400370,Client_53,2022-04-19,2022-07-01,2022-07-18,5214,2129,3085
400371,Client_54,2023-08-12,2023-11-08,2023-12-11,1992,430,1562
400372,Client_54,2021-02-12,2021-04-06,2021-05-21,1230,376,854
400373,Client_54,2021-02-24,2021-04-11,2021-08-08,767,147,620
400374,Client_54,2023-02-14,2023-03-20,2023-06-11,15435,10465,4970
400375,Client_54,2022-01-10,2022-03-15,2022-07-11,6100,4332,1768
400376,Client_54,2023-03-22,2023-04-07,2023-07-20,5109,2200,2909
400377,Client_55,2023-03-02,2023-04-09,2023-05-22,9000,8795,205
400378,Client_55,2022-12-30,2023-01-23,2023-01-24,8640,5286,3354
400379,Client_55,2022-11-07,2022-12-09,2023-03-16,15916,9305,6611
400380,Client_56,2021-01-18,2021-04-17,2021-06-29,8513,5439,3074
400381,Client_56,2022-05-07,2022-07-13,2022-10-28,5372,2698,2674
400382,Client_56,2021-03-11,2021-05-22,2021-05-24,1827,424,1403
400383,Client_56,2021-12-11,2022-03-07,2022-06-11,11655,5166,6489
400384,Client_56,2022-08-08,2022-11-04,2023-02-15,7194,1618,5576
400385,Client_56,2021-06-08,2021-07-26,2021-10-27,3384,552,2832
400386,Client_56,2023-08-27,2023-11-12,2023-12-31,5415,4037,1378
400387,Client_56,2021-09-21,2021-11-08,2022-02-20,15346,5319,10027
400388,Client_56,2023-07-24,2023-09-21,2023-12-06,12489,2297,10192
400389,Client_56,2021-08-28,2021-11-16,2022-03-06,1278,287,991
400390,Client_56,2023-06-19,2023-07-26,2023-10-20,1891,654,1237
400391,Client_56,2023-05-27,2023-06-23,2023-07-07,19668,16003,3665
400392,Client_57,2021-02-23,2021-04-16,2021-05-06,12103,9891,2212
400393,Client_57,2021-02-11,2021-04-13,2021-05-03,19154,3162,15992
400394,Client_57,2021-06-26,2021-07-21,2021-10-27,17895,1365,16530
400395,Client_57,2021-02-23,2021-03-17,2021-06-07,13953,6186,7767
400396,Client_57,2021-08-05,2021-09-19,2022-01-07,7840,2508,5332
400397,Client_57,2021-01-12,2021-02-01,2021-03-09,3611,1285,2326
400398,Client_57,2023-01-15,2023-02-03,2023-02-18,4224,1864,2360
400399,Client_57,2023-08-19,2023-10-29,2023-11-09,19195,10021,9174
400400,Client_57,2021-10-11,2021-10-30,2022-02-23,18632,11534,7098
400401,Client_57,2022-11-22,2022-12-09,2023-02-26,3120,201,2919
400402,Client_58,2021-08-19,2021-10-22,2022-01-29,18818,14501,4317
400403,Client_58,2022-02-09,2022-05-06,2022-08-21,3051,1731,1320
400404,Client_58,2021-08-01,2021-08-21,2021-08-22,1501,1376,125
400405,Client_58,2022-11-15,2023-01-28,2023-03-22,19016,1824,17192
400406,Client_58,2021-05-07,2021-06-15,2021-06-29,17622,7827,9795
400407,Client_58,2022-02-22,2022-05-11,2022-07-06,6882,4987,1895
400408,Client_58,2021-09-29,2021-10-17,2022-01-10,10724,2391,8333
400409,Client_58,2022-03-29,2022-06-15,2022-08-06,18627,8136,10491
400410,Client_58,2021-01-15,2021-03-04,2021-05-15,17307,15661,1646
400411,Client_58,2022-05-20,2022-07-12,2022-11-08,3557,2299,1258
400412,Client_58,2021-02-16,2021-04-11,2021-06-18,7726,5922,1804
400413,Client_58,2023-05-07,2023-07-16,2023-07-17,19861,169,19692
400414,Client_59,2021-08-27,2021-10-23,2021-12-11,13216,8496,4720
400415,Client_59,2022-03-08,2022-04-22,2022-04-24,13594,4515,9079
400416,Client_59,2022-11-07,2023-01-02,2023-02-10,17274,3248,14026
400417,Client_59,2021-11-21,2022-01-20,2022-04-23,9593,4096,5497
400418,Client_59,2022-03-28,2022-05-07,2022-06-01,18444,2357,16087
400419,Client_60,2022-09-10,2022-11-28,2023-02-19,7499,2315,5184
400420,Client_60,2023-02-24,2023-04-10,2023-04-29,6353,5313,1040
400421,Client_60,2021-10-16,2022-01-12,2022-01-23,3432,956,2476
400422,Client_60,2021-09-12,2021-12-10,2021-12-17,3039,1313,1726
400423,Client_60,2021-11-07,2022-01-22,2022-03-12,3651,1003,2648
400424,Client_60,2023-09-24,2023-12-07,2024-03-18,8560,4126,4434
400425,Client_60,2021-07-19,2021-08-06,2021-08-20,4650,912,3738
400426,Client_60,2023-04-15,2023-05-01,2023-06-09,13772,6549,7223
400427,Client_60,2022-07-08,2022-08-06,2022-08-12,18367,1336,17031
400428,Client_60,2023-07-16,2023-08-10,2023-09-10,4943,1838,3105
400429,Client_60,2023-01-08,2023-01-30,2023-03-28,16875,3865,13010
400430,Client_60,2023-09-24,2023-10-20,2024-02-12,3026,380,2646
400431,Client_61,2023-04-22,2023-06-30,2023-08-23,14430,13315,1115
400432,Client_61,2021-06-24,2021-08-05,2021-09-26,19804,36,19768
400433,Client_61,2021-08-23,2021-09-09,2021-11-18,15726,13427,2299
400434,Client_61,2021-03-15,2021-04-03,2021-04-12,17377,3877,13500
400435,Client_61,2021-05-16,2021-07-28,2021-09-21,12689,6137,6552
400436,Client_61,2023-07-04,2023-09-02,2023-11-25,2577,1446,1131
400437,Client_61,2022-11-11,2023-01-15,2023-01-20,4734,4076,658
400438,Client_61,2022-02-14,2022-03-18,2022-03-31,16401,2289,14112
400439,Client_62,2022-08-31,2022-11-13,2022-11-23,13976,90,13886
400440,Client_62,2022-02-05,2022-03-05,2022-06-28,4053,2019,2034
400441,Client_62,2021-09-27,2021-11-27,2021-12-02,17633,11314,6319
400442,Client_62,2023-08-29,2023-10-16,2023-11-23,4924,4125,799
400443,Client_62,2022-04-22,2022-06-10,2022-07-08,13481,7476,6005
400444,Client_62,2021-06-06,2021-08-21,2021-09-25,914,596,318
400445,Client_62,2022-02-02,2022-03-03,2022-05-11,5349,1677,3672
400446,Client_62,2022-02-07,2022-04-30,2022-06-24,19213,4801,14412
400447,Client_62,2022-06-13,2022-08-21,2022-10-27,3089,456,2633
400448,Client_62,2021-11-16,2022-01-05,2022-03-10,9305,5332,3973
400449,Client_62,2021-12-14,2022-01-24,2022-02-24,8952,560,8392
400450,Client_62,2023-05-29,2023-08-17,2023-10-27,10192,4219,5973
400451,Client_62,2021-04-05,2021-06-01,2021-07-16,19081,8281,10800
400452,Client_62,2023-07-12,2023-10-02,2023-12-28,13364,2418,10946
400453,Client_63,2022-06-01,2022-07-12,2022-07-15,9989,1411,8578
400454,Client_63,2023-05-02,2023-06-20,2023-10-03,861,268,593
400455,Client_64,2021-07-14,2021-09-27,2021-12-04,15509,14565,944
400456,Client_64,2022-05-31,2022-07-16,2022-09-05,1918,318,1600
400457,Client_64,2021-11-02,2021-12-11,2022-03-03,9373,8456,917
400458,Client_64,2022-04-07,2022-05-12,2022-08-07,10120,6581,3539
400459,Client_64,2022-03-08,2022-03-23,2022-06-11,14166,13922,244
400460,Client_64,2021-08-27,2021-10-25,2021-11-21,11917,411,11506
400461,Client_64,2022-10-14,2022-12-07,2023-03-30,4746,210,4536
400462,Client_65,2021-01-02,2021-03-16,2021-07-01,8778,1704,7074
400463,Client_65,2022-09-21,2022-11-17,2022-12-12,10331,3715,6616
400464,Client_65,2022-06-09,2022-09-05,2022-11-07,3702,1444,2258
400465,Client_65,2021-07-11,2021-09-29,2022-01-08,3676,436,3240
400466,Client_65,2021-07-26,2021-09-27,2021-12-24,10396,1486,8910
400467,Client_65,2023-04-28,2023-06-18,2023-09-16,6412,5029,1383
400468,Client_65,2022-02-18,2022-05-06,2022-08-18,10132,2317,7815
400469,Client_65,2023-04-27,2023-06-12,2023-08-08,6877,4544,2333
400470,Client_65,2022-10-10,2022-12-01,2023-02-14,9758,1881,7877
400471,Client_65,2021-05-30,2021-07-20,2021-08-16,10898,2587,8311
400472,Client_65,2021-05-09,2021-05-27,2021-09-13,16867,16021,846
400473,Client_66,2022-06-21,2022-07-21,2022-10-11,2084,43,2041
400474,Client_66,2022-03-05,2022-04-18,2022-07-20,14834,2402,12432
400475,Client_67,2021-04-20,2021-05-25,2021-07-14,11269,11066,203
400476,Client_67,2021-09-10,2021-11-06,2021-12-15,8034,7679,355
400477,Client_67,2022-08-03,2022-10-26,2023-01-31,10910,6987,3923
400478,Client_67,2021-07-14,2021-08-19,2021-09-07,13420,13326,94
400479,Client_67,2023-08-28,2023-10-31,2024-02-10,10831,10403,428
400480,Client_67,2022-12-08,2023-01-04,2023-01-16,12839,1740,11099
400481,Client_68,2022-01-25,2022-04-15,2022-08-06,19511,3131,16380
400482,Client_68,2023-09-04,2023-12-01,2024-02-12,11229,7694,3535
400483,Client_68,2023-09-25,2023-11-23,2024-02-29,6096,888,5208
400484,Client_68,2022-07-04,2022-09-26,2022-12-01,14818,5561,9257
400485,Client_68,2021-11-12,2021-12-08,2022-02-02,9309,3516,5793
400486,Client_68,2021-10-10,2021-12-21,2022-01-21,535,425,110
400487,Client_68,2023-04-18,2023-05-17,2023-07-20,18371,472,17899
400488,Client_68,2021-05-12,2021-05-28,2021-08-06,12195,11207,988
400489,Client_68,2021-09-07,2021-11-30,2022-02-24,18567,16917,1650
400490,Client_68,2022-11-06,2022-12-14,2023-03-05,12834,8400,4434
400491,Client_69,2022-01-15,2022-03-02,2022-03-29,7683,3554,4129
400492,Client_69,2021-02-17,2021-05-09,2021-07-30,6579,5175,1404
400493,Client_69,2022-12-24,2023-01-19,2023-01-27,3431,2898,533
400494,Client_70,2023-05-25,2023-08-10,2023-11-20,3172,326,2846
400495,Client_70,2023-08-13,2023-11-08,2024-02-07,1973,614,1359
400496,Client_70,2022-11-12,2022-12-31,2023-01-08,18956,9109,9847
400497,Client_70,2022-12-10,2023-02-03,2023-02-16,13834,9982,3852
400498,Client_70,2023-04-05,2023-04-21,2023-06-06,11039,11017,22
400499,Client_70,2021-01-27,2021-03-27,2021-05-21,5902,1684,4218
400500,Client_70,2022-11-12,2022-12-02,2022-12-31,2313,340,1973
400501,Client_70,2022-12-28,2023-02-25,2023-04-24,9089,4858,4231
400502,Client_70,2022-02-03,2022-02-24,2022-04-19,8996,2814,6182
400503,Client_70,2022-12-09,2023-02-14,2023-03-03,18126,18068,58
400504,Client_70,2022-10-04,2022-11-25,2022-12-13,3743,1791,1952
400505,Client_70,2021-03-21,2021-04-30,2021-08-16,10351,6809,3542
400506,Client_71,2022-04-02,2022-04-26,2022-06-21,9326,7299,2027
400507,Client_71,2021-01-01,2021-03-11,2021-05-13,11985,8223,3762
400508,Client_71,2023-03-04,2023-04-03,2023-07-17,18708,17508,1200
400509,Client_71,2023-06-23,2023-09-11,2023-12-18,6671,2201,4470
400510,Client_71,2021-04-27,2021-06-20,2021-06-29,8352,6919,1433
400511,Client_71,2021-07-09,2021-08-30,2021-09-07,18343,6505,11838
400512,Client_71,2023-05-06,2023-06-30,2023-07-27,1782,289,1493
400513,Client_71,2022-06-30,2022-09-14,2022-10-10,547,242,305
400514,Client_71,2022-10-04,2022-12-30,2023-01-27,18417,829,17588
400515,Client_71,2022-09-28,2022-12-15,2023-03-08,13374,9309,4065
400516,Client_71,2022-02-15,2022-05-15,2022-07-21,4139,2061,2078
400517,Client_71,2022-03-16,2022-06-01,2022-09-07,19256,9373,9883
400518,Client_71,2022-08-07,2022-10-14,2022-12-23,17626,7282,10344
400519,Client_71,2023-05-15,2023-06-01,2023-08-10,11671,10701,970
400520,Client_72,2023-05-19,2023-06-23,2023-07-02,3175,2639,536
400521,Client_72,2022-04-03,2022-05-13,2022-06-16,9648,6429,3219
400522,Client_72,2021-01-04,2021-02-07,2021-02-16,1433,479,954
400523,Client_72,2021-02-16,2021-03-11,2021-05-25,15752,12232,3520
400524,Client_72,2022-03-04,2022-05-22,2022-06-21,16987,5073,11914
400525,Client_72,2022-08-27,2022-09-15,2023-01-07,7085,3996,3089
400526,Client_72,2022-06-09,2022-08-19,2022-10-28,5645,4032,1613
400527,Client_72,2021-01-04,2021-03-24,2021-05-13,11941,1268,10673
400528,Client_72,2021-01-02,2021-02-11,2021-05-06,14170,1355,12815
400529,Client_72,2023-02-12,2023-04-04,2023-06-23,18859,8721,10138
400530,Client_72,2023-06-27,2023-09-08,2023-10-19,13664,11604,2060
400531,Client_72,2022-03-18,2022-04-24,2022-04-26,5049,3817,1232
400532,Client_72,2022-08-26,2022-10-04,2022-10-14,13036,12522,514
400533,Client_73,2021-03-29,2021-04-29,2021-07-24,19607,17059,2548
400534,Client_74,2023-03-13,2023-04-17,2023-05-17,10505,8118,2387
400535,Client_74,2023-07-06,2023-07-27,2023-11-04,10137,1644,8493
400536,Client_74,2021-10-09,2021-11-21,2022-03-07,13767,7155,6612
400537,Client_74,2023-05-26,2023-06-11,2023-08-15,11165,5488,5677
400538,Client_74,2023-05-12,2023-06-15,2023-06-27,2737,803,1934
400539,Client_74,2023-02-14,2023-05-14,2023-07-06,12520,150,12370
400540,Client_74,2021-09-05,2021-10-16,2021-10-23,6609,383,6226
400541,Client_74,2021-03-28,2021-06-18,2021-10-08,707,484,223
400542,Client_74,2023-04-19,2023-07-16,2023-09-13,4189,3063,1126
400543,Client_74,2022-08-13,2022-10-16,2023-01-12,14973,6562,8411
400544,Client_75,2021-12-28,2022-02-27,2022-04-16,14626,1289,13337
400545,Client_75,2021-05-07,2021-05-22,2021-08-10,18174,14798,3376
400546,Client_75,2021-03-03,2021-04-06,2021-07-26,18061,8737,9324
400547,Client_75,2021-04-28,2021-07-06,2021-10-10,8679,3370,5309
400548,Client_75,2023-03-11,2023-04-07,2023-08-03,5506,2730,2776
400549,Client_75,2021-06-30,2021-08-26,2021-11-15,2673,651,2022
400550,Client_75,2021-07-20,2021-09-27,2021-10-25,9223,1223,8000
400551,Client_75,2022-08-06,2022-09-24,2022-12-14,12495,5596,6899
400552,Client_75,2021-05-23,2021-06-29,2021-10-12,17603,7529,10074
400553,Client_75,2021-07-28,2021-10-16,2021-10-19,19537,2639,16898
400554,Client_75,2022-10-06,2022-10-28,2022-10-29,13585,2089,11496
400555,Client_76,2022-06-05,2022-06-25,2022-06-25,10794,4129,6665
400556,Client_76,2022-03-22,2022-04-19,2022-06-14,6279,86,6193
400557,Client_76,2021-02-19,2021-04-28,2021-05-22,2021,227,1794
400558,Client_76,2022-03-23,2022-05-23,2022-09-10,2266,1767,499
400559,Client_76,2022-04-17,2022-07-12,2022-11-08,12290,1764,10526
400560,Client_76,2021-05-26,2021-07-06,2021-09-07,15654,8954,6700
400561,Client_76,2023-01-09,2023-03-25,2023-05-30,5221,2248,2973
400562,Client_76,2022-01-04,2022-02-03,2022-02-09,19994,11786,8208
400563,Client_76,2021-03-28,2021-05-22,2021-06-06,15705,11146,4559
400564,Client_77,2021-12-19,2022-01-28,2022-04-16,16432,10215,6217
400565,Client_77,2022-03-04,2022-05-06,2022-08-19,6560,5475,1085
400566,Client_77,2022-03-24,2022-04-10,2022-05-31,11915,109,11806
400567,Client_77,2022-07-15,2022-10-11,2022-11-14,656,110,546
400568,Client_77,2021-07-18,2021-08-11,2021-08-20,10551,1545,9006
400569,Client_77,2023-02-22,2023-03-23,2023-06-11,10638,7825,2813
400570,Client_77,2021-10-07,2021-11-25,2022-01-03,13701,2817,10884
400571,Client_77,2023-06-14,2023-07-17,2023-08-22,19666,4028,15638
400572,Client_78,2021-08-26,2021-10-14,2021-11-24,6962,2482,4480
400573,Client_79,2023-06-21,2023-07-14,2023-08-21,7758,5068,2690
400574,Client_79,2023-03-06,2023-05-19,2023-07-21,16658,14423,2235
400575,Client_79,2023-08-04,2023-08-28,2023-09-26,6770,3030,3740
400576,Client_79,2021-05-08,2021-07-23,2021-08-26,6032,1735,4297
400577,Client_79,2023-04-24,2023-05-23,2023-09-04,5300,806,4494
400578,Client_79,2021-12-24,2022-02-03,2022-04-14,13477,11404,2073
400579,Client_79,2022-07-02,2022-08-30,2022-11-27,5972,2442,3530
400580,Client_79,2023-02-11,2023-03-17,2023-04-30,15703,9388,6315
400581,Client_80,2022-03-01,2022-04-24,2022-08-10,10784,9702,1082
400582,Client_80,2021-10-29,2021-12-19,2022-01-25,18752,876,17876
400583,Client_80,2022-05-02,2022-06-09,2022-07-04,12553,7144,5409
400584,Client_81,2021-02-05,2021-04-14,2021-04-17,19370,2375,16995
400585,Client_81,2022-01-15,2022-04-05,2022-05-09,4293,3013,1280
400586,Client_81,2022-12-26,2023-03-23,2023-05-25,6519,4688,1831
400587,Client_81,2022-05-09,2022-06-30,2022-09-18,11666,1530,10136
400588,Client_81,2023-06-26,2023-09-07,2024-01-03,16923,8518,8405
400589,Client_81,2021-09-03,2021-10-09,2021-11-20,19204,4501,14703
400590,Client_82,2022-12-02,2023-02-23,2023-05-23,2628,120,2508
400591,Client_82,2021-01-08,2021-03-14,2021-05-01,2875,81,2794
400592,Client_82,2021-08-01,2021-09-14,2021-11-26,846,714,132
400593,Client_82,2022-01-01,2022-03-06,2022-04-24,1777,15,1762
400594,Client_82,2022-07-23,2022-08-26,2022-09-04,8470,4143,4327
400595,Client_82,2023-03-24,2023-06-04,2023-07-13,14588,2401,12187
400596,Client_82,2022-04-04,2022-05-07,2022-08-14,5331,156,5175
400597,Client_82,2021-12-13,2022-02-14,2022-03-04,6758,6062,696
400598,Client_82,2022-05-08,2022-06-17,2022-08-24,2499,1113,1386
400599,Client_82,2021-05-16,2021-07-11,2021-09-08,11332,10923,409
400600,Client_82,2022-12-12,2022-12-27,2023-01-02,7967,5149,2818
400601,Client_82,2022-04-09,2022-07-05,2022-10-24,13234,5098,8136
400602,Client_82,2022-11-23,2022-12-19,2023-02-01,7728,3373,4355
400603,Client_82,2021-05-19,2021-07-09,2021-08-31,6314,6082,232
400604,Client_83,2022-04-02,2022-05-03,2022-08-03,18578,12594,5984
400605,Client_83,2023-08-27,2023-10-10,2023-12-29,1138,105,1033
400606,Client_83,2021-10-21,2021-11-07,2022-03-04,7474,4868,2606
400607,Client_83,2023-09-18,2023-11-04,2024-01-24,18009,232,17777
400608,Client_83,2023-02-13,2023-03-15,2023-05-21,2691,2054,637
400609,Client_83,2022-02-12,2022-03-24,2022-07-17,1863,459,1404
400610,Client_83,2021-11-06,2021-11-22,2022-01-04,17273,9661,7612
400611,Client_84,2023-05-02,2023-07-18,2023-11-06,14405,5025,9380
400612,Client_84,2022-07-31,2022-09-18,2022-11-16,14919,1571,13348
400613,Client_84,2023-07-03,2023-09-02,2023-09-11,3982,3353,629
400614,Client_84,2023-04-04,2023-05-16,2023-07-29,2736,2718,18
400615,Client_84,2023-08-05,2023-10-27,2023-11-01,1521,237,1284
400616,Client_84,2021-05-03,2021-06-08,2021-10-03,3347,2418,929
400617,Client_84,2021-05-19,2021-07-20,2021-07-30,4605,2333,2272
400618,Client_84,2021-11-15,2021-12-10,2022-02-15,3830,1836,1994
400619,Client_84,2021-08-30,2021-10-23,2022-01-16,8754,4495,4259
400620,Client_84,2021-02-28,2021-05-11,2021-05-21,8509,8308,201
400621,Client_85,2022-06-27,2022-07-29,2022-10-25,14965,11073,3892
400622,Client_85,2022-09-27,2022-11-14,2023-01-25,5672,5569,103
400623,Client_85,2022-11-21,2023-01-24,2023-03-03,18970,9472,9498
400624,Client_86,2022-02-11,2022-03-21,2022-05-22,16990,12501,4489
400625,Client_86,2021-12-13,2022-02-13,2022-05-02,15275,3214,12061
400626,Client_86,2023-06-15,2023-08-26,2023-12-08,1237,232,1005
400627,Client_86,2021-12-08,2022-02-03,2022-04-27,1517,738,779
400628,Client_86,2023-06-24,2023-09-05,2023-12-14,15516,942,14574
400629,Client_86,2022-05-05,2022-07-20,2022-10-12,5177,1637,3540
400630,Client_86,2022-03-31,2022-05-22,2022-06-07,8916,4121,4795
400631,Client_86,2022-11-17,2022-12-24,2023-01-10,847,258,589
400632,Client_86,2021-01-30,2021-04-06,2021-05-06,14806,12666,2140
400633,Client_86,2023-01-05,2023-03-22,2023-07-16,3935,2528,1407
400634,Client_86,2023-09-25,2023-12-16,2023-12-24,9468,3031,6437
400635,Client_86,2021-11-30,2022-02-12,2022-02-25,6822,4226,2596
400636,Client_87,2022-03-23,2022-06-13,2022-10-09,1635,814,821
400637,Client_87,2023-05-19,2023-07-28,2023-11-05,17954,17619,335
400638,Client_87,2022-01-19,2022-03-01,2022-05-26,13274,10859,2415
400639,Client_87,2021-09-03,2021-11-17,2021-12-13,16622,3633,12989
400640,Client_87,2023-05-19,2023-06-21,2023-08-16,19356,18801,555
400641,Client_87,2022-10-23,2022-12-19,2022-12-27,11413,7190,4223
400642,Client_88,2021-01-26,2021-04-03,2021-06-27,16929,9427,7502
400643,Client_88,2022-06-15,2022-07-24,2022-08-04,4936,1652,3284
400644,Client_88,2021-08-23,2021-11-19,2022-02-10,7708,2618,5090
400645,Client_88,2023-07-12,2023-08-11,2023-12-06,10178,4958,5220
400646,Client_88,2022-05-13,2022-07-11,2022-11-01,8115,4153,3962
400647,Client_88,2021-05-06,2021-06-28,2021-10-03,13773,10823,2950
400648,Client_88,2022-04-08,2022-06-08,2022-07-29,2136,920,1216
400649,Client_88,2022-11-12,2022-12-22,2023-01-06,14386,784,13602
400650,Client_88,2022-05-12,2022-07-24,2022-10-02,11545,8178,3367
400651,Client_88,2022-08-14,2022-11-04,2023-03-02,9278,6474,2804
400652,Client_88,2023-06-19,2023-08-19,2023-12-06,19020,1307,17713
400653,Client_88,2021-05-06,2021-05-25,2021-07-29,1632,378,1254
400654,Client_88,2021-03-06,2021-05-13,2021-08-31,17313,16910,403
400655,Client_89,2021-03-04,2021-04-01,2021-04-26,13216,3160,10056
400656,Client_89,2023-04-15,2023-06-07,2023-08-03,12811,8340,4471
400657,Client_89,2022-02-09,2022-03-24,2022-06-13,12731,4737,7994
400658,Client_89,2021-10-12,2021-11-19,2022-01-09,3168,691,2477
400659,Client_90,2021-01-03,2021-02-22,2021-03-25,4472,3765,707
400660,Client_90,2021-03-04,2021-04-09,2021-04-18,8617,7104,1513
400661,Client_90,2023-07-04,2023-09-18,2023-12-24,18835,18491,344
400662,Client_90,2022-06-11,2022-08-23,2022-10-04,13256,12020,1236
400663,Client_90,2021-10-25,2021-12-15,2022-01-30,9363,5997,3366
400664,Client_90,2021-02-05,2021-04-02,2021-07-30,19089,7568,11521
400665,Client_91,2021-01-30,2021-04-16,2021-07-09,13417,11791,1626
400666,Client_91,2022-02-02,2022-02-26,2022-04-08,19407,13927,5480
400667,Client_91,2023-08-31,2023-11-03,2024-01-30,8026,6674,1352
400668,Client_91,2022-07-22,2022-09-18,2022-12-03,6803,5856,947
400669,Client_91,2022-07-06,2022-09-09,2022-11-15,12097,3642,8455
400670,Client_91,2021-05-22,2021-07-25,2021-08-31,18658,4425,14233
400671,Client_91,2022-12-31,2023-02-06,2023-06-01,19573,5948,13625
400672,Client_91,2021-07-08,2021-08-06,2021-10-02,12119,7727,4392
400673,Client_91,2022-01-03,2022-03-30,2022-05-22,1124,308,816
400674,Client_91,2021-08-10,2021-09-03,2021-11-11,8054,321,7733
400675,Client_92,2021-12-06,2022-02-20,2022-04-12,2108,1155,953
400676,Client_92,2022-03-09,2022-06-05,2022-07-10,10115,4244,5871
400677,Client_92,2022-09-27,2022-11-08,2023-02-04,4127,3594,533
400678,Client_92,2021-10-01,2021-11-17,2022-01-21,12200,11429,771
400679,Client_92,2021-12-26,2022-02-11,2022-02-28,1019,288,731
400680,Client_92,2021-11-10,2022-02-03,2022-03-30,5083,1503,3580
400681,Client_92,2022-01-13,2022-03-25,2022-06-22,17773,9825,7948
400682,Client_92,2022-09-30,2022-11-24,2023-02-04,18664,10087,8577
400683,Client_92,2023-04-10,2023-05-18,2023-07-10,1860,1578,282
400684,Client_92,2021-04-15,2021-06-16,2021-09-10,4684,2604,2080
400685,Client_92,2023-01-07,2023-02-22,2023-04-02,17355,14029,3326
400686,Client_92,2021-08-23,2021-09-20,2021-10-16,4680,1291,3389
400687,Client_92,2022-07-29,2022-09-23,2022-10-21,10468,3159,7309
400688,Client_93,2021-11-01,2021-12-07,2022-01-15,1478,1034,444
400689,Client_93,2021-03-18,2021-06-14,2021-07-20,4502,2730,1772
400690,Client_93,2021-03-16,2021-05-18,2021-09-03,5859,2435,3424
400691,Client_93,2022-10-30,2022-12-09,2023-02-03,2875,2086,789
400692,Client_93,2022-12-01,2022-12-17,2023-02-21,1623,468,1155
400693,Client_93,2023-08-15,2023-09-30,2023-11-11,17489,11495,5994
400694,Client_93,2021-12-28,2022-01-31,2022-03-21,10243,6341,3902
400695,Client_93,2022-10-13,2022-12-26,2022-12-29,9011,6488,2523
400696,Client_93,2022-11-18,2023-01-07,2023-03-06,8807,144,8663
400697,Client_93,2021-09-13,2021-10-08,2021-11-11,16480,6735,9745
400698,Client_93,2023-09-02,2023-09-21,2023-12-19,4309,3848,461
400699,Client_93,2022-06-30,2022-09-05,2022-09-22,13009,6522,6487
400700,Client_93,2022-06-10,2022-06-28,2022-08-13,16170,3649,12521
400701,Client_94,2021-12-07,2022-01-14,2022-02-22,3193,451,2742
400702,Client_94,2023-01-26,2023-02-13,2023-06-04,13858,12289,1569
400703,Client_94,2021-09-12,2021-12-01,2022-02-07,1881,964,917
400704,Client_94,2023-01-03,2023-02-04,2023-02-04,7453,6347,1106
400705,Client_94,2022-09-21,2022-10-20,2023-02-15,15456,8566,6890
400706,Client_94,2022-07-09,2022-09-24,2022-10-21,2893,2835,58
400707,Client_94,2022-02-18,2022-04-26,2022-08-17,17747,3420,14327
400708,Client_94,2021-04-22,2021-05-29,2021-08-17,11649,4474,7175
400709,Client_94,2022-11-04,2023-02-01,2023-05-18,3573,3376,197
400710,Client_94,2022-05-08,2022-07-21,2022-08-13,8378,1216,7162
400711,Client_94,2021-04-27,2021-07-13,2021-11-08,7218,3585,3633
400712,Client_94,2021-10-04,2021-11-29,2022-03-01,5354,4811,543
400713,Client_95,2023-04-23,2023-07-18,2023-10-11,18838,136,18702
400714,Client_95,2021-02-07,2021-04-08,2021-05-15,4548,2551,1997
400715,Client_95,2022-03-10,2022-05-04,2022-08-09,9413,1515,7898
400716,Client_95,2021-05-22,2021-06-24,2021-09-13,17123,2102,15021
400717,Client_95,2022-03-11,2022-05-26,2022-08-23,3956,3418,538
400718,Client_95,2021-08-21,2021-10-30,2021-11-06,10647,2095,8552
400719,Client_95,2021-05-11,2021-06-18,2021-08-27,4753,2553,2200
400720,Client_96,2021-12-15,2022-01-24,2022-03-26,6001,3379,2622
400721,Client_96,2022-06-12,2022-08-06,2022-11-14,889,878,11
400722,Client_96,2021-08-23,2021-10-20,2021-12-03,7219,6621,598
400723,Client_96,2022-12-22,2023-03-21,2023-06-27,9478,6846,2632
400724,Client_97,2022-06-30,2022-09-12,2022-10-26,14004,939,13065
400725,Client_97,2021-10-31,2021-12-07,2022-02-02,2410,1749,661
400726,Client_97,2022-05-08,2022-06-18,2022-10-04,2228,2220,8
400727,Client_97,2022-12-20,2023-02-23,2023-05-15,4678,1928,2750
400728,Client_97,2021-05-11,2021-06-13,2021-08-06,19544,15486,4058
400729,Client_97,2022-11-30,2022-12-28,2023-04-07,7682,3634,4048
400730,Client_97,2022-10-20,2022-12-01,2022-12-15,8237,5311,2926
400731,Client_97,2021-01-14,2021-03-02,2021-06-16,541,493,48
400732,Client_97,2021-08-30,2021-11-04,2021-12-28,9786,5526,4260
400733,Client_97,2021-06-06,2021-07-10,2021-09-19,1454,1337,117
400734,Client_98,2021-03-20,2021-05-19,2021-06-07,14500,12537,1963
400735,Client_98,2022-08-29,2022-11-13,2023-03-03,16622,6290,10332
400736,Client_98,2021-12-03,2022-01-01,2022-03-04,16100,15442,658
400737,Client_98,2021-08-04,2021-08-21,2021-10-06,17504,4705,12799
400738,Client_98,2021-09-22,2021-10-17,2021-11-20,10543,8892,1651
400739,Client_98,2021-08-18,2021-11-15,2021-12-17,10089,9812,277
400740,Client_99,2022-03-20,2022-05-04,2022-07-26,4608,540,4068
400741,Client_99,2023-04-01,2023-06-08,2023-09-18,16765,6209,10556
400742,Client_99,2021-05-05,2021-07-22,2021-08-16,19298,18589,709
400743,Client_99,2022-05-28,2022-08-14,2022-09-17,13565,12213,1352
400744,Client_99,2022-12-15,2023-03-02,2023-04-23,14028,8479,5549
400745,Client_99,2021-12-07,2022-02-03,2022-03-20,2577,195,2382
400746,Client_99,2021-03-14,2021-05-06,2021-06-24,8556,1276,7280
400747,Client_99,2022-10-03,2022-11-21,2022-11-28,14950,3892,11058
400748,Client_99,2021-08-07,2021-09-30,2021-10-26,5393,2056,3337
400749,Client_99,2023-03-21,2023-06-12,2023-08-03,13581,12989,592
400750,Client_99,2022-12-21,2023-01-11,2023-03-17,7493,2325,5168
400751,Client_99,2022-03-09,2022-04-25,2022-06-07,18106,13059,5047
400752,Client_100,2022-03-02,2022-05-25,2022-08-17,1885,881,1004
400753,Client_100,2021-08-15,2021-09-25,2021-12-05,15042,13219,1823
400754,Client_101,2021-04-15,2021-06-21,2021-10-03,1584,830,754
400755,Client_102,2023-05-09,2023-06-21,2023-08-27,9713,8142,1571
400756,Client_102,2021-06-15,2021-08-02,2021-11-12,1484,978,506
400757,Client_102,2022-05-21,2022-07-11,2022-07-13,10948,2092,8856
400758,Client_102,2021-12-27,2022-03-05,2022-06-29,4331,3807,524
400759,Client_102,2022-08-10,2022-10-11,2023-01-05,15521,13602,1919
400760,Client_102,2021-02-12,2021-03-04,2021-06-25,5459,3742,1717
400761,Client_102,2022-06-24,2022-07-14,2022-09-08,5412,4824,588
400762,Client_102,2022-09-02,2022-10-27,2023-01-22,15186,781,14405
400763,Client_103,2021-01-29,2021-02-27,2021-05-28,8449,5535,2914
400764,Client_103,2021-03-11,2021-05-26,2021-08-26,3563,785,2778
400765,Client_103,2022-12-19,2023-03-07,2023-04-03,16860,10503,6357
400766,Client_103,2022-04-07,2022-05-04,2022-08-24,13948,1851,12097
400767,Client_103,2021-02-03,2021-02-18,2021-02-21,9065,3866,5199
400768,Client_103,2023-06-02,2023-08-08,2023-12-05,1233,706,527
400769,Client_103,2022-05-30,2022-06-28,2022-09-10,16214,2611,13603
400770,Client_103,2023-04-20,2023-05-16,2023-05-29,13375,11522,1853
400771,Client_103,2022-06-22,2022-07-18,2022-09-28,12410,996,11414
400772,Client_103,2023-08-05,2023-08-29,2023-12-25,11688,640,11048
400773,Client_104,2021-10-02,2021-11-25,2022-02-05,16610,9392,7218
400774,Client_104,2021-05-13,2021-06-16,2021-08-30,16266,3730,12536
400775,Client_104,2022-09-21,2022-11-09,2023-02-07,18283,8662,9621
400776,Client_104,2021-07-15,2021-10-11,2022-01-17,2457,2248,209
400777,Client_104,2022-01-22,2022-04-03,2022-05-02,4811,1577,3234
400778,Client_104,2021-10-09,2021-12-19,2022-03-27,9563,1374,8189
400779,Client_104,2021-04-27,2021-06-10,2021-07-26,10714,9977,737
400780,Client_105,2021-05-05,2021-05-26,2021-07-15,12123,10797,1326
400781,Client_105,2022-10-21,2022-11-16,2023-01-09,3287,2338,949
400782,Client_105,2022-06-25,2022-09-11,2022-11-27,3249,886,2363
400783,Client_105,2022-02-24,2022-03-27,2022-05-08,19153,8398,10755
400784,Client_105,2023-07-09,2023-09-17,2023-12-15,2865,2416,449
400785,Client_106,2022-12-25,2023-01-18,2023-04-15,4323,1663,2660
400786,Client_106,2022-01-19,2022-03-02,2022-06-05,16751,14130,2621
400787,Client_106,2022-05-15,2022-06-14,2022-07-14,14036,919,13117
400788,Client_106,2021-08-11,2021-10-10,2021-11-20,10297,7082,3215
400789,Client_106,2021-07-14,2021-09-26,2022-01-01,14044,12930,1114
400790,Client_107,2023-07-01,2023-07-18,2023-10-25,12856,11042,1814
400791,Client_107,2021-10-17,2021-11-18,2021-12-11,1436,572,864
400792,Client_107,2023-03-21,2023-05-01,2023-05-14,14262,8241,6021
400793,Client_107,2022-08-26,2022-09-22,2022-11-24,10062,4883,5179
400794,Client_107,2021-09-20,2021-10-21,2021-11-04,5081,1751,3330
400795,Client_107,2022-12-21,2023-01-23,2023-02-24,8334,1978,6356
400796,Client_107,2021-03-15,2021-05-21,2021-08-05,17291,1142,16149
400797,Client_107,2022-01-16,2022-02-01,2022-05-26,14632,7744,6888
400798,Client_107,2022-06-27,2022-09-02,2022-09-12,505,384,121
400799,Client_107,2021-12-06,2022-02-18,2022-05-05,14401,9320,5081
400800,Client_107,2021-05-03,2021-07-19,2021-08-09,18330,17781,549
400801,Client_107,2022-11-04,2023-01-21,2023-02-02,3140,306,2834
400802,Client_108,2022-10-08,2022-12-12,2023-02-15,8258,5891,2367
400803,Client_108,2022-04-20,2022-06-09,2022-08-30,7543,3126,4417
400804,Client_108,2023-02-08,2023-03-11,2023-03-14,15469,7763,7706
400805,Client_108,2021-04-04,2021-06-29,2021-06-29,11347,11028,319
400806,Client_108,2022-10-03,2022-11-03,2023-02-05,7235,2778,4457
400807,Client_109,2022-06-08,2022-08-16,2022-11-10,5845,2655,3190
400808,Client_109,2021-11-20,2022-01-11,2022-01-18,9019,4892,4127
400809,Client_109,2022-04-25,2022-06-26,2022-06-28,15420,9844,5576
400810,Client_109,2021-06-09,2021-08-14,2021-12-11,14421,4729,9692
400811,Client_109,2023-04-13,2023-06-20,2023-10-17,1265,418,847
400812,Client_109,2023-07-03,2023-07-23,2023-09-21,1205,898,307
400813,Client_109,2022-07-22,2022-09-03,2022-09-10,8842,3516,5326
400814,Client_109,2021-01-20,2021-03-23,2021-06-05,6324,1822,4502
400815,Client_109,2023-04-09,2023-05-10,2023-05-13,2483,480,2003
400816,Client_110,2023-04-01,2023-05-17,2023-08-08,10928,6315,4613
400817,Client_110,2021-03-27,2021-04-30,2021-07-04,3440,1507,1933
400818,Client_110,2021-03-24,2021-05-15,2021-09-03,11540,4448,7092
400819,Client_110,2022-03-18,2022-04-18,2022-05-02,17958,9182,8776
400820,Client_111,2022-05-23,2022-07-08,2022-10-09,18632,1754,16878
400821,Client_111,2021-01-03,2021-02-20,2021-03-27,11728,4743,6985
400822,Client_111,2021-04-19,2021-05-22,2021-06-30,1852,523,1329
400823,Client_111,2021-12-22,2022-02-14,2022-05-03,11998,5978,6020
400824,Client_111,2021-08-06,2021-10-03,2021-12-11,14780,9548,5232
400825,Client_111,2023-02-05,2023-03-24,2023-06-02,17204,1947,15257
400826,Client_111,2023-01-06,2023-02-15,2023-06-07,17019,12394,4625
400827,Client_112,2021-08-17,2021-11-10,2022-01-04,10594,10280,314
400828,Client_112,2023-01-07,2023-01-29,2023-03-17,11061,9466,1595
400829,Client_112,2022-02-02,2022-03-22,2022-04-17,10574,1734,8840
400830,Client_112,2022-07-13,2022-09-24,2022-10-11,17729,14554,3175
400831,Client_112,2021-07-26,2021-08-14,2021-09-10,11742,2607,9135
400832,Client_112,2022-04-08,2022-06-23,2022-09-05,18685,7947,10738
400833,Client_112,2023-08-01,2023-10-01,2023-12-03,18621,6669,11952
400834,Client_112,2021-07-15,2021-07-31,2021-11-21,12921,1793,11128
400835,Client_112,2022-02-26,2022-05-17,2022-06-11,2288,929,1359
400836,Client_112,2022-07-10,2022-08-29,2022-11-21,17305,11854,5451
400837,Client_112,2021-12-05,2022-01-28,2022-04-16,11639,8731,2908
400838,Client_112,2021-11-15,2022-01-21,2022-01-25,12230,1474,10756
400839,Client_113,2021-08-21,2021-10-28,2021-12-18,14082,12009,2073
400840,Client_113,2021-12-12,2022-01-16,2022-04-21,17766,6487,11279
400841,Client_113,2022-01-19,2022-04-12,2022-07-17,6071,1024,5047
400842,Client_113,2021-11-09,2022-01-08,2022-04-12,11625,10704,921
400843,Client_113,2021-02-12,2021-05-06,2021-06-18,11886,1439,10447
400844,Client_113,2021-06-24,2021-07-11,2021-09-01,9387,4483,4904
400845,Client_114,2021-06-07,2021-07-04,2021-09-29,8341,862,7479
400846,Client_114,2021-04-06,2021-06-01,2021-07-22,17838,14087,3751
400847,Client_114,2023-09-21,2023-10-13,2023-11-07,748,591,157
400848,Client_114,2022-08-25,2022-10-31,2023-02-20,14213,5119,9094
400849,Client_114,2023-06-29,2023-08-13,2023-11-24,6793,335,6458
400850,Client_114,2023-05-18,2023-07-17,2023-11-12,502,250,252
400851,Client_115,2023-05-15,2023-07-28,2023-10-15,17889,10369,7520
400852,Client_115,2021-04-30,2021-05-31,2021-07-24,13032,12082,950
400853,Client_115,2023-04-22,2023-06-05,2023-06-09,2505,263,2242
400854,Client_115,2021-01-21,2021-03-29,2021-04-04,4750,2756,1994
400855,Client_115,2021-01-02,2021-03-31,2021-06-29,17183,5924,11259
400856,Client_115,2023-05-31,2023-08-06,2023-10-19,2660,1064,1596
400857,Client_115,2021-04-28,2021-07-03,2021-09-30,15644,8922,6722
400858,Client_115,2023-07-24,2023-08-31,2023-09-30,2751,261,2490
400859,Client_115,2022-07-05,2022-09-25,2022-10-31,15963,6154,9809
400860,Client_115,2022-01-18,2022-04-12,2022-05-19,10126,8768,1358
400861,Client_115,2023-04-11,2023-05-15,2023-07-04,8675,1606,7069
400862,Client_115,2023-03-02,2023-05-27,2023-07-06,13532,13069,463
400863,Client_115,2023-01-24,2023-04-03,2023-04-07,15926,7817,8109
400864,Client_116,2023-06-12,2023-07-19,2023-07-20,11793,7028,4765
400865,Client_116,2022-09-22,2022-11-15,2022-12-04,1500,1321,179
400866,Client_116,2023-05-05,2023-06-20,2023-08-20,7687,2296,5391
400867,Client_116,2021-05-13,2021-08-06,2021-09-02,12799,1662,11137
400868,Client_116,2022-06-14,2022-06-29,2022-10-11,6156,2657,3499
400869,Client_116,2021-05-05,2021-05-20,2021-08-12,15227,13320,1907
400870,Client_116,2022-03-23,2022-05-23,2022-08-15,14307,5781,8526
400871,Client_116,2022-09-27,2022-11-07,2022-12-13,15610,14727,883
400872,Client_116,2021-05-05,2021-05-31,2021-06-17,620,135,485
400873,Client_116,2023-07-28,2023-09-13,2023-11-15,14710,11557,3153
400874,Client_117,2021-12-23,2022-01-21,2022-04-02,8740,5419,3321
400875,Client_117,2021-04-08,2021-05-23,2021-09-14,13252,8521,4731
400876,Client_117,2022-11-17,2022-12-19,2023-02-02,13737,12808,929
400877,Client_117,2021-09-28,2021-11-08,2022-02-03,19993,15336,4657
400878,Client_117,2021-06-11,2021-08-03,2021-11-11,5369,501,4868
400879,Client_117,2022-04-30,2022-05-29,2022-08-15,18951,9035,9916
400880,Client_117,2022-09-06,2022-11-03,2023-01-03,3432,1816,1616
400881,Client_117,2023-01-31,2023-04-21,2023-06-12,9102,4145,4957
400882,Client_117,2023-06-20,2023-09-16,2023-09-20,17795,6451,11344
400883,Client_117,2021-12-13,2022-01-23,2022-04-19,4579,1180,3399
400884,Client_118,2021-04-07,2021-05-29,2021-07-06,625,204,421
400885,Client_118,2023-02-24,2023-03-15,2023-03-26,8819,523,8296
400886,Client_118,2023-07-24,2023-10-06,2023-12-06,7638,7373,265
400887,Client_118,2022-04-28,2022-06-24,2022-10-19,8987,7738,1249
400888,Client_118,2023-03-07,2023-04-13,2023-06-11,12049,4432,7617
400889,Client_118,2021-09-23,2021-12-05,2022-01-16,19782,9034,10748
400890,Client_118,2023-03-14,2023-05-21,2023-08-30,6102,4858,1244
400891,Client_118,2021-02-13,2021-04-13,2021-05-01,19542,1681,17861
400892,Client_118,2021-07-01,2021-08-26,2021-10-24,7864,1066,6798
400893,Client_118,2022-06-22,2022-08-22,2022-10-05,4911,3832,1079
400894,Client_118,2021-03-12,2021-06-01,2021-09-08,13443,10757,2686
400895,Client_118,2021-12-07,2022-02-09,2022-05-11,13141,4046,9095
400896,Client_119,2023-03-01,2023-05-21,2023-06-22,12672,3124,9548
400897,Client_119,2023-04-07,2023-05-26,2023-07-20,18314,14606,3708
400898,Client_119,2022-06-23,2022-08-05,2022-08-13,2477,437,2040
400899,Client_120,2023-03-02,2023-05-27,2023-05-31,7068,6817,251
400900,Client_120,2021-06-19,2021-09-11,2021-11-26,2897,2102,795
400901,Client_120,2023-05-15,2023-06-11,2023-07-11,19444,6846,12598
400902,Client_120,2022-08-24,2022-09-22,2022-12-17,9802,6108,3694
400903,Client_120,2021-09-13,2021-11-09,2021-12-12,2468,2089,379
400904,Client_120,2023-02-07,2023-05-03,2023-05-20,7048,5866,1182
400905,Client_121,2023-09-20,2023-10-20,2023-12-10,16798,727,16071
400906,Client_121,2023-03-30,2023-05-15,2023-07-28,9909,6713,3196
400907,Client_122,2022-02-10,2022-04-07,2022-05-27,16485,6587,9898
400908,Client_122,2021-02-05,2021-04-04,2021-06-07,6133,3841,2292
400909,Client_122,2021-06-19,2021-08-29,2021-12-15,16751,11200,5551
400910,Client_122,2022-03-12,2022-05-25,2022-08-22,2568,1787,781
400911,Client_122,2021-07-15,2021-08-10,2021-12-07,3197,2897,300
400912,Client_122,2022-01-12,2022-03-04,2022-06-04,6371,1104,5267
400913,Client_122,2022-06-14,2022-07-10,2022-09-09,11890,10608,1282
400914,Client_122,2021-11-27,2022-01-13,2022-04-04,13128,4367,8761
400915,Client_122,2022-04-29,2022-07-19,2022-11-14,8633,6466,2167
400916,Client_122,2021-09-11,2021-10-14,2021-11-02,9830,8565,1265
400917,Client_122,2021-01-22,2021-02-25,2021-03-21,8935,6794,2141
400918,Client_123,2022-12-31,2023-01-30,2023-02-25,11987,8750,3237
400919,Client_123,2021-08-02,2021-09-23,2021-10-24,14665,1756,12909
400920,Client_123,2022-10-24,2022-11-17,2022-12-31,8315,4432,3883
400921,Client_123,2023-07-06,2023-09-30,2023-11-09,4524,3313,1211
400922,Client_123,2022-01-11,2022-04-04,2022-06-04,15735,3920,11815
400923,Client_123,2022-01-28,2022-04-13,2022-08-01,17034,14393,2641
400924,Client_123,2022-05-06,2022-05-24,2022-09-10,19119,11776,7343
400925,Client_123,2023-02-26,2023-04-18,2023-05-15,3927,1609,2318
400926,Client_123,2022-01-31,2022-02-28,2022-03-25,14169,10195,3974
400927,Client_124,2022-05-30,2022-06-23,2022-07-31,8241,7151,1090
400928,Client_124,2021-11-04,2021-11-21,2022-03-01,9698,8026,1672
400929,Client_124,2022-05-20,2022-06-22,2022-06-27,16933,2759,14174
400930,Client_124,2022-12-05,2022-12-25,2023-04-18,19403,13250,6153
400931,Client_124,2021-08-01,2021-08-23,2021-12-17,9466,3798,5668
400932,Client_124,2023-07-11,2023-10-02,2024-01-26,14444,4243,10201
400933,Client_124,2022-08-14,2022-09-14,2022-10-19,17711,9240,8471
400934,Client_125,2021-05-10,2021-06-30,2021-09-07,7889,1516,6373
400935,Client_125,2021-10-26,2021-12-21,2022-01-05,19912,68,19844
400936,Client_125,2022-01-22,2022-04-20,2022-07-10,8383,5785,2598
400937,Client_125,2021-03-28,2021-06-17,2021-09-21,18498,15440,3058
400938,Client_125,2022-08-10,2022-09-14,2022-10-27,16021,5148,10873
400939,Client_125,2023-04-18,2023-05-09,2023-05-31,14410,4705,9705
400940,Client_125,2021-02-07,2021-03-05,2021-06-14,4663,612,4051
400941,Client_125,2021-03-25,2021-04-15,2021-06-11,9961,3838,6123
400942,Client_126,2022-01-04,2022-03-31,2022-06-12,8535,798,7737
400943,Client_126,2021-06-15,2021-08-07,2021-09-01,1575,966,609
400944,Client_126,2022-10-22,2022-11-13,2023-01-18,2587,37,2550
400945,Client_126,2023-03-12,2023-05-19,2023-06-22,15002,14496,506
400946,Client_126,2021-08-20,2021-10-02,2021-12-13,12039,7585,4454
400947,Client_126,2022-11-02,2023-01-20,2023-03-17,14212,12107,2105
400948,Client_126,2021-10-31,2021-11-16,2022-02-10,7401,1093,6308
400949,Client_126,2021-08-28,2021-10-27,2022-01-19,16818,16397,421
400950,Client_126,2023-02-28,2023-04-26,2023-05-22,2343,58,2285
400951,Client_126,2021-12-22,2022-03-18,2022-04-26,19625,8733,10892
400952,Client_126,2023-06-15,2023-08-27,2023-09-12,16352,8751,7601
400953,Client_126,2021-01-23,2021-04-16,2021-04-17,15806,9800,6006
400954,Client_126,2023-01-04,2023-02-18,2023-03-21,16775,1792,14983
400955,Client_126,2023-05-11,2023-07-02,2023-07-13,17626,12114,5512
400956,Client_127,2022-02-02,2022-02-26,2022-04-04,19210,4393,14817
400957,Client_127,2023-04-02,2023-06-03,2023-08-01,12796,11431,1365
400958,Client_127,2022-08-21,2022-09-05,2022-12-16,17361,7721,9640
400959,Client_127,2023-07-13,2023-09-16,2023-11-28,16376,13743,2633
400960,Client_127,2023-05-08,2023-06-19,2023-10-03,15063,8412,6651
400961,Client_127,2022-08-30,2022-09-18,2022-10-01,6846,2473,4373
400962,Client_127,2023-09-19,2023-11-30,2024-01-13,14987,3799,11188
400963,Client_127,2023-04-04,2023-04-28,2023-05-18,19307,15595,3712
400964,Client_127,2021-08-23,2021-11-20,2022-01-12,14985,4203,10782
400965,Client_127,2023-06-20,2023-08-19,2023-09-23,6419,5337,1082
400966,Client_128,2023-05-24,2023-07-05,2023-07-17,19680,8447,11233
400967,Client_128,2021-08-24,2021-10-24,2022-01-11,16450,7594,8856
400968,Client_128,2021-04-29,2021-05-23,2021-07-16,1785,1093,692
400969,Client_128,2021-05-08,2021-07-24,2021-10-03,1749,1283,466
400970,Client_128,2022-08-04,2022-10-27,2022-12-06,2825,801,2024
400971,Client_128,2023-04-22,2023-05-14,2023-09-04,8265,6957,1308
400972,Client_128,2021-08-21,2021-11-13,2022-01-04,13228,11124,2104
400973,Client_128,2022-03-03,2022-04-06,2022-07-31,4785,1108,3677
400974,Client_128,2021-05-06,2021-05-26,2021-08-21,5990,5790,200
400975,Client_128,2021-11-11,2022-01-18,2022-04-10,9159,1314,7845
400976,Client_128,2021-08-17,2021-09-08,2021-11-20,16291,15152,1139
400977,Client_128,2022-10-20,2022-11-21,2023-02-24,13703,69,13634
400978,Client_128,2023-01-31,2023-04-06,2023-04-18,16348,9449,6899
400979,Client_129,2021-04-25,2021-06-24,2021-08-31,14085,8313,5772
400980,Client_129,2021-06-25,2021-07-31,2021-11-15,10953,1466,9487
400981,Client_129,2023-08-23,2023-11-06,2024-02-08,6403,3550,2853
400982,Client_129,2021-09-25,2021-12-15,2022-04-13,8346,3315,5031
400983,Client_129,2021-03-17,2021-06-07,2021-06-15,1526,1022,504
400984,Client_129,2021-11-09,2021-11-27,2021-12-20,12803,6847,5956
400985,Client_129,2022-11-25,2023-01-07,2023-03-13,16347,4633,11714
400986,Client_129,2022-12-03,2023-01-26,2023-05-25,13505,11252,2253
400987,Client_130,2022-12-06,2023-02-05,2023-03-03,6744,2119,4625
400988,Client_130,2021-09-07,2021-11-01,2022-01-06,1532,607,925
400989,Client_130,2021-03-03,2021-05-05,2021-08-19,4041,829,3212
400990,Client_130,2021-11-25,2022-02-13,2022-05-02,12272,10520,1752
400991,Client_130,2022-07-05,2022-08-17,2022-10-23,19002,16506,2496
400992,Client_130,2023-06-04,2023-06-23,2023-08-11,19037,87,18950
400993,Client_130,2021-12-23,2022-02-18,2022-06-05,11226,6612,4614
400994,Client_130,2021-03-15,2021-03-30,2021-06-02,16939,4899,12040
400995,Client_130,2021-07-14,2021-08-29,2021-11-30,12877,7623,5254
400996,Client_130,2021-02-28,2021-05-16,2021-07-20,3380,2141,1239
400997,Client_130,2021-05-27,2021-08-14,2021-09-27,11941,2277,9664
400998,Client_130,2022-06-25,2022-08-18,2022-11-01,18629,14214,4415
400999,Client_130,2021-02-06,2021-04-29,2021-05-06,10079,7241,2838
401000,Client_131,2022-10-13,2023-01-08,2023-02-05,15693,7237,8456
401001,Client_131,2023-06-12,2023-08-22,2023-10-21,2921,1673,1248
401002,Client_131,2023-05-14,2023-06-07,2023-06-28,9856,3988,5868
401003,Client_131,2023-07-10,2023-08-29,2023-09-21,12994,12090,904
401004,Client_131,2022-03-29,2022-06-21,2022-08-21,8209,4916,3293
401005,Client_132,2021-03-12,2021-03-29,2021-06-22,5663,2773,2890
401006,Client_132,2022-12-18,2023-02-04,2023-02-20,9325,5802,3523
401007,Client_132,2023-09-12,2023-12-05,2023-12-23,8533,6560,1973
401008,Client_132,2022-09-02,2022-10-23,2022-11-29,7447,4045,3402
401009,Client_132,2022-08-27,2022-10-02,2022-12-17,13146,4694,8452
401010,Client_132,2022-11-17,2023-02-13,2023-05-25,15716,3690,12026
401011,Client_132,2021-11-05,2021-12-15,2022-03-04,4043,959,3084
401012,Client_132,2023-02-27,2023-05-09,2023-08-15,2304,1554,750
401013,Client_133,2023-05-06,2023-06-06,2023-06-29,1416,1110,306
401014,Client_133,2023-01-13,2023-02-16,2023-03-16,16578,9166,7412
401015,Client_133,2022-08-15,2022-10-16,2023-01-16,5258,4930,328
401016,Client_134,2022-02-18,2022-05-03,2022-08-16,19846,12571,7275
401017,Client_134,2023-03-22,2023-04-10,2023-06-02,9726,4591,5135
401018,Client_134,2022-03-16,2022-04-19,2022-07-06,8040,1414,6626
401019,Client_134,2022-10-06,2022-11-25,2023-02-26,7004,4053,2951
401020,Client_134,2021-01-25,2021-03-13,2021-04-14,19000,18521,479
401021,Client_134,2023-07-10,2023-08-16,2023-08-31,9145,7804,1341
401022,Client_134,2022-03-30,2022-04-20,2022-06-19,10605,1999,8606
401023,Client_135,2021-10-12,2022-01-02,2022-04-10,13674,848,12826
401024,Client_135,2023-07-15,2023-08-28,2023-12-11,17267,6410,10857
401025,Client_135,2022-12-28,2023-03-25,2023-07-08,3002,531,2471
401026,Client_135,2023-02-02,2023-04-21,2023-05-27,4888,3054,1834
401027,Client_135,2023-07-30,2023-09-21,2023-10-18,19525,2188,17337
401028,Client_135,2021-11-10,2022-01-05,2022-02-07,13871,11525,2346
401029,Client_135,2023-04-30,2023-07-02,2023-10-26,7073,1443,5630
401030,Client_135,2021-02-28,2021-04-26,2021-08-22,8450,3457,4993
401031,Client_135,2022-08-12,2022-09-12,2022-09-29,3201,2445,756
401032,Client_135,2022-01-24,2022-02-21,2022-02-24,16012,3594,12418
401033,Client_135,2022-09-08,2022-12-03,2023-01-10,5152,4483,669
401034,Client_135,2022-06-23,2022-08-22,2022-10-08,17386,241,17145
401035,Client_135,2023-09-21,2023-11-08,2024-01-23,8441,6258,2183
401036,Client_135,2021-12-13,2022-01-28,2022-04-03,2485,2319,166
401037,Client_136,2022-11-20,2023-02-09,2023-06-05,1405,1007,398
401038,Client_136,2022-05-11,2022-06-18,2022-09-07,4841,2537,2304
401039,Client_136,2021-02-11,2021-05-07,2021-08-23,4740,2650,2090
401040,Client_136,2023-09-15,2023-11-29,2024-03-01,1183,600,583
401041,Client_136,2021-01-26,2021-02-19,2021-03-30,13341,1479,11862
401042,Client_136,2021-10-01,2021-12-20,2022-02-23,896,654,242
401043,Client_136,2022-04-30,2022-07-02,2022-08-03,14132,7458,6674
401044,Client_136,2022-03-25,2022-04-10,2022-05-28,14149,12090,2059
401045,Client_136,2022-03-04,2022-04-21,2022-07-20,13111,112,12999
401046,Client_137,2021-05-10,2021-05-31,2021-06-21,11417,1945,9472
401047,Client_137,2021-05-06,2021-06-30,2021-08-13,6551,3784,2767
401048,Client_137,2021-07-01,2021-08-16,2021-09-23,4702,2670,2032
401049,Client_137,2022-08-09,2022-09-12,2022-09-18,11339,3453,7886
401050,Client_137,2021-10-26,2021-11-24,2022-03-15,11325,11224,101
401051,Client_138,2021-11-16,2022-02-03,2022-03-17,3227,2572,655
401052,Client_138,2022-10-11,2022-11-15,2023-02-20,16531,654,15877
401053,Client_138,2022-09-29,2022-11-23,2022-12-13,18183,11736,6447
401054,Client_138,2023-05-17,2023-06-22,2023-08-15,5718,999,4719
401055,Client_138,2021-02-13,2021-04-18,2021-04-27,16336,14867,1469
401056,Client_138,2021-01-13,2021-03-22,2021-04-10,7408,4101,3307
401057,Client_139,2023-09-02,2023-10-03,2024-01-02,3802,3672,130
401058,Client_139,2023-02-25,2023-05-05,2023-06-07,15592,5912,9680
401059,Client_139,2022-03-09,2022-04-27,2022-08-02,14532,6252,8280
401060,Client_139,2021-07-14,2021-08-09,2021-10-11,12065,3450,8615
401061,Client_139,2022-03-05,2022-05-16,2022-05-31,5037,1312,3725
401062,Client_139,2022-01-14,2022-02-26,2022-06-14,16533,16276,257
401063,Client_139,2023-09-08,2023-10-15,2024-02-02,19568,2247,17321
401064,Client_139,2022-09-22,2022-11-20,2023-02-09,8661,6206,2455
401065,Client_139,2021-05-31,2021-06-19,2021-09-30,3943,1225,2718
401066,Client_139,2022-10-12,2022-12-29,2023-03-26,14498,3595,10903
401067,Client_139,2021-07-22,2021-09-24,2021-12-30,15515,4803,10712
401068,Client_140,2023-01-23,2023-04-13,2023-05-06,1326,1300,26
401069,Client_140,2023-04-01,2023-06-28,2023-08-30,1714,952,762
401070,Client_140,2023-09-12,2023-11-07,2024-02-27,18483,11762,6721
401071,Client_140,2022-06-21,2022-08-10,2022-09-09,6417,2430,3987
401072,Client_140,2023-04-18,2023-06-10,2023-08-16,13302,4115,9187
401073,Client_140,2023-02-03,2023-04-23,2023-07-22,13494,9692,3802
401074,Client_140,2022-07-08,2022-07-26,2022-07-26,19731,12345,7386
401075,Client_140,2023-06-27,2023-08-04,2023-08-04,10747,7799,2948
401076,Client_140,2021-12-26,2022-03-22,2022-06-03,12569,5793,6776
401077,Client_140,2022-06-26,2022-09-12,2022-10-13,16446,8175,8271
401078,Client_140,2023-05-21,2023-07-03,2023-07-15,19678,4135,15543
401079,Client_140,2021-05-25,2021-07-14,2021-09-12,15793,5735,10058
401080,Client_140,2022-03-07,2022-05-18,2022-08-11,14954,2721,12233
401081,Client_140,2021-03-22,2021-06-14,2021-09-19,4154,2676,1478
401082,Client_141,2022-09-09,2022-11-01,2023-01-24,7761,673,7088
401083,Client_141,2023-06-11,2023-08-23,2023-10-30,3537,2788,749
401084,Client_141,2023-09-18,2023-10-06,2024-02-01,5696,1926,3770
401085,Client_141,2023-03-11,2023-04-14,2023-07-27,11449,7284,4165
401086,Client_141,2022-11-24,2023-01-14,2023-01-23,5160,3691,1469
401087,Client_141,2022-06-11,2022-08-27,2022-11-02,19902,13043,6859
401088,Client_141,2023-05-24,2023-07-22,2023-09-13,6176,3493,2683
401089,Client_141,2021-06-22,2021-09-11,2021-12-02,3129,2787,342
401090,Client_141,2021-08-06,2021-08-23,2021-10-24,8841,6217,2624
401091,Client_141,2021-07-04,2021-08-13,2021-10-14,1816,1617,199
401092,Client_141,2022-06-27,2022-09-16,2023-01-12,13606,3331,10275
401093,Client_141,2021-12-05,2022-01-15,2022-01-17,1464,1038,426
401094,Client_141,2022-03-08,2022-05-20,2022-07-26,11601,11540,61
401095,Client_142,2023-03-11,2023-06-03,2023-09-12,17013,598,16415
401096,Client_142,2023-06-01,2023-08-15,2023-11-13,504,270,234
401097,Client_142,2022-09-25,2022-11-22,2023-02-08,9034,622,8412
401098,Client_142,2023-09-05,2023-12-01,2023-12-17,6379,327,6052
401099,Client_142,2022-09-18,2022-10-29,2023-01-14,13787,4962,8825
401100,Client_142,2023-08-20,2023-11-05,2024-01-09,18924,6771,12153
401101,Client_142,2022-07-20,2022-10-04,2023-01-27,10875,1258,9617
401102,Client_142,2021-05-14,2021-06-22,2021-09-08,11096,4517,6579
401103,Client_142,2022-01-27,2022-02-25,2022-04-19,19173,14108,5065
401104,Client_143,2021-06-26,2021-09-04,2021-11-30,803,356,447
401105,Client_143,2023-02-14,2023-03-21,2023-06-10,15706,4576,11130
401106,Client_143,2023-06-17,2023-08-13,2023-09-01,7683,1252,6431
401107,Client_143,2021-09-15,2021-10-17,2022-02-11,18142,4715,13427
401108,Client_143,2022-12-19,2023-03-13,2023-06-30,13243,10610,2633
401109,Client_143,2023-01-01,2023-02-04,2023-04-03,4673,1586,3087
401110,Client_143,2023-04-24,2023-06-29,2023-09-05,3925,915,3010
401111,Client_143,2021-07-26,2021-08-13,2021-10-09,3865,1258,2607
401112,Client_143,2022-12-05,2023-02-13,2023-04-21,6856,351,6505
401113,Client_144,2022-04-06,2022-05-10,2022-08-06,19073,2070,17003
401114,Client_144,2023-01-12,2023-02-24,2023-05-22,8293,2625,5668
401115,Client_144,2021-03-21,2021-05-26,2021-07-28,10076,181,9895
401116,Client_144,2023-04-28,2023-06-23,2023-08-30,5724,2061,3663
401117,Client_144,2022-03-10,2022-05-01,2022-05-07,9379,7335,2044
401118,Client_144,2022-09-24,2022-10-29,2022-11-28,17274,15794,1480
401119,Client_144,2022-09-28,2022-12-13,2023-01-16,13048,6479,6569
401120,Client_144,2022-10-08,2022-11-23,2022-11-23,3018,2533,485
401121,Client_144,2023-04-26,2023-07-08,2023-10-28,19134,9277,9857
401122,Client_144,2021-07-08,2021-08-22,2021-09-06,17668,481,17187
401123,Client_145,2022-03-28,2022-05-02,2022-06-11,17063,12390,4673
401124,Client_145,2022-06-11,2022-08-05,2022-11-10,11952,7039,4913
401125,Client_145,2021-06-14,2021-08-09,2021-10-23,14709,12327,2382
401126,Client_145,2022-01-22,2022-04-11,2022-04-26,622,107,515
401127,Client_145,2023-06-21,2023-07-24,2023-10-02,5108,4736,372
401128,Client_145,2022-05-03,2022-06-04,2022-08-13,17232,13711,3521
401129,Client_146,2023-04-26,2023-06-11,2023-08-22,17131,7790,9341
401130,Client_146,2021-03-24,2021-05-01,2021-08-22,3335,491,2844
401131,Client_146,2022-01-18,2022-04-04,2022-07-24,1844,1542,302
401132,Client_146,2021-09-20,2021-12-12,2021-12-21,14536,6230,8306
401133,Client_146,2022-12-16,2023-01-27,2023-02-27,17074,6493,10581
401134,Client_146,2022-07-23,2022-08-12,2022-11-12,5777,2768,3009
401135,Client_146,2022-10-24,2022-11-17,2023-01-29,2813,121,2692
401136,Client_147,2022-01-16,2022-03-18,2022-05-17,14506,12486,2020
401137,Client_147,2022-03-27,2022-06-04,2022-09-30,16224,11348,4876
401138,Client_147,2023-08-24,2023-10-19,2024-01-20,7274,1516,5758
401139,Client_147,2021-10-07,2021-11-20,2022-02-24,1025,985,40
401140,Client_147,2022-08-07,2022-10-22,2023-01-27,11795,1272,10523
401141,Client_147,2021-07-24,2021-09-09,2021-10-26,11027,3917,7110
401142,Client_147,2023-06-16,2023-08-29,2023-10-29,6119,519,5600
401143,Client_147,2023-04-18,2023-06-30,2023-09-30,3261,715,2546
401144,Client_147,2023-04-19,2023-06-27,2023-10-03,19929,17318,2611
401145,Client_147,2021-08-22,2021-10-17,2021-10-23,15004,14819,185
401146,Client_148,2023-09-12,2023-11-13,2023-12-25,8274,8171,103
401147,Client_148,2021-08-03,2021-10-13,2021-12-10,1892,1698,194
401148,Client_149,2022-04-13,2022-06-30,2022-08-16,1816,323,1493
401149,Client_149,2023-06-06,2023-06-26,2023-09-30,8767,5449,3318
401150,Client_149,2022-08-13,2022-08-30,2022-09-17,17415,2681,14734
401151,Client_149,2021-07-19,2021-09-02,2021-09-25,11677,217,11460
401152,Client_149,2023-02-22,2023-03-17,2023-04-06,8828,1958,6870
401153,Client_149,2023-07-31,2023-09-15,2023-12-16,10796,10499,297
401154,Client_149,2022-03-17,2022-04-26,2022-06-01,14861,10211,4650
401155,Client_149,2023-06-21,2023-08-11,2023-10-18,3981,2794,1187
401156,Client_149,2022-03-05,2022-03-22,2022-05-16,4174,3701,473
401157,Client_149,2022-02-09,2022-03-04,2022-04-03,2297,1450,847
401158,Client_149,2022-01-27,2022-04-24,2022-06-24,12806,7534,5272
401159,Client_149,2023-01-26,2023-02-14,2023-04-02,6179,3712,2467
401160,Client_150,2021-08-31,2021-11-03,2022-02-16,9564,1080,8484
401161,Client_150,2023-05-31,2023-08-07,2023-10-15,14002,2537,11465
401162,Client_150,2022-09-04,2022-10-10,2022-12-09,16927,14125,2802
401163,Client_150,2023-03-19,2023-05-10,2023-07-18,12403,8138,4265
401164,Client_150,2023-04-16,2023-05-07,2023-06-08,7401,3460,3941
401165,Client_150,2023-05-12,2023-05-28,2023-09-24,8520,2632,5888
401166,Client_150,2021-01-02,2021-02-20,2021-04-21,8438,2102,6336
401167,Client_150,2022-09-25,2022-10-25,2023-01-20,15526,1516,14010
401168,Client_150,2022-12-04,2023-01-27,2023-05-13,7358,533,6825
401169,Client_150,2023-06-23,2023-08-30,2023-09-28,8886,2083,6803
401170,Client_150,2021-04-30,2021-07-25,2021-09-03,10429,5979,4450
401171,Client_150,2021-07-28,2021-08-20,2021-09-29,18204,17120,1084
401172,Client_150,2021-08-25,2021-10-26,2022-01-25,4381,3736,645
401173,Client_150,2022-09-18,2022-11-19,2023-02-12,8104,2049,6055
401174,Client_151,2023-06-19,2023-07-16,2023-08-07,1147,399,748
401175,Client_151,2022-11-06,2022-12-07,2023-02-14,5636,3591,2045
401176,Client_152,2023-01-10,2023-02-23,2023-05-15,2494,368,2126
401177,Client_152,2022-07-26,2022-08-19,2022-12-10,536,2,534
401178,Client_152,2021-06-12,2021-07-31,2021-09-14,5514,2677,2837
401179,Client_152,2023-03-02,2023-05-16,2023-05-27,9856,8458,1398
401180,Client_152,2021-02-21,2021-05-17,2021-06-11,1050,523,527
401181,Client_152,2022-08-20,2022-10-08,2022-12-25,4345,173,4172
401182,Client_152,2022-07-24,2022-08-21,2022-09-21,9819,7072,2747
401183,Client_152,2021-11-23,2021-12-28,2022-04-13,19959,7484,12475
401184,Client_152,2021-11-06,2021-12-15,2022-03-21,1109,466,643
401185,Client_152,2021-04-12,2021-05-05,2021-08-07,11105,5666,5439
401186,Client_152,2023-03-17,2023-05-25,2023-09-19,15346,5169,10177
401187,Client_152,2023-07-13,2023-09-22,2024-01-12,17560,7816,9744
401188,Client_153,2023-04-07,2023-05-07,2023-07-18,12826,4120,8706
401189,Client_153,2023-04-06,2023-05-22,2023-06-17,9896,2241,7655
401190,Client_153,2021-12-25,2022-03-04,2022-03-19,18821,1517,17304
401191,Client_154,2022-07-08,2022-07-27,2022-11-20,2059,1634,425
401192,Client_154,2022-06-06,2022-07-19,2022-08-01,2589,2519,70
401193,Client_154,2022-03-14,2022-04-21,2022-07-27,4693,3695,998
401194,Client_154,2021-02-17,2021-05-08,2021-07-08,19011,9168,9843
401195,Client_155,2021-02-03,2021-05-01,2021-08-24,8559,1144,7415
401196,Client_155,2021-02-10,2021-02-27,2021-05-30,13998,10753,3245
401197,Client_155,2023-05-30,2023-06-27,2023-07-01,7331,3759,3572
401198,Client_155,2022-05-11,2022-06-10,2022-06-30,4161,353,3808
401199,Client_155,2023-09-08,2023-11-08,2023-12-31,8508,1021,7487
401200,Client_155,2023-07-19,2023-08-07,2023-10-07,8026,1012,7014
401201,Client_155,2021-09-01,2021-09-30,2021-10-31,10338,1270,9068
401202,Client_155,2022-05-31,2022-08-14,2022-08-22,18931,1670,17261
401203,Client_155,2021-08-20,2021-10-18,2021-12-02,16676,15542,1134
401204,Client_155,2023-02-07,2023-03-19,2023-05-28,7759,1252,6507
401205,Client_155,2021-07-05,2021-08-10,2021-08-17,10241,3022,7219
401206,Client_156,2021-12-12,2022-01-15,2022-02-05,13375,9805,3570
401207,Client_156,2023-05-23,2023-08-15,2023-11-28,3566,135,3431
401208,Client_157,2023-07-23,2023-08-17,2023-09-22,7819,3327,4492
401209,Client_157,2021-11-25,2022-01-13,2022-02-10,4323,2941,1382
401210,Client_157,2023-01-25,2023-03-01,2023-04-24,18151,8141,10010
401211,Client_157,2021-08-25,2021-09-28,2021-10-18,5796,1416,4380
401212,Client_157,2022-01-13,2022-03-03,2022-03-15,2854,832,2022
401213,Client_157,2022-02-01,2022-04-09,2022-06-20,3475,3083,392
401214,Client_157,2022-03-01,2022-05-24,2022-07-24,17279,10752,6527
401215,Client_157,2023-07-26,2023-08-29,2023-10-16,3911,426,3485
401216,Client_157,2023-09-17,2023-11-22,2024-02-28,6470,5380,1090
401217,Client_157,2022-03-24,2022-06-11,2022-07-09,16559,6068,10491
401218,Client_157,2022-09-18,2022-10-23,2022-10-24,2370,1285,1085
401219,Client_158,2022-06-03,2022-06-18,2022-09-07,11028,6669,4359
401220,Client_159,2022-02-07,2022-03-21,2022-03-28,11060,5994,5066
401221,Client_159,2022-08-27,2022-11-20,2023-01-16,5321,110,5211
401222,Client_159,2021-08-23,2021-10-14,2021-12-05,9741,5687,4054
401223,Client_159,2023-07-25,2023-09-10,2023-12-30,1756,166,1590
401224,Client_159,2023-07-22,2023-09-21,2024-01-05,15145,1061,14084
401225,Client_159,2021-09-12,2021-10-11,2021-10-30,14070,8918,5152
401226,Client_159,2021-04-02,2021-05-24,2021-09-17,16613,16443,170
401227,Client_159,2021-12-02,2022-02-25,2022-03-28,2410,1501,909
401228,Client_160,2021-12-15,2022-03-03,2022-03-18,14512,8977,5535
401229,Client_160,2022-11-03,2022-12-21,2023-01-26,5199,670,4529
401230,Client_160,2022-04-19,2022-05-07,2022-05-15,8754,3168,5586
401231,Client_160,2023-05-22,2023-08-11,2023-09-10,4707,1511,3196
401232,Client_161,2023-03-11,2023-05-16,2023-07-19,13343,4174,9169
401233,Client_161,2021-06-24,2021-07-28,2021-08-21,15140,12705,2435
401234,Client_161,2023-08-03,2023-10-27,2023-11-05,1957,1078,879
401235,Client_161,2022-10-17,2022-12-05,2023-02-26,15974,15048,926
401236,Client_161,2021-07-30,2021-09-20,2021-11-03,18885,18759,126
401237,Client_161,2023-08-03,2023-09-21,2024-01-13,11686,10102,1584
401238,Client_161,2022-10-23,2023-01-17,2023-03-08,10634,8280,2354
401239,Client_161,2021-10-17,2022-01-06,2022-01-28,18663,10375,8288
401240,Client_161,2021-04-27,2021-07-19,2021-08-09,2535,572,1963
401241,Client_161,2023-08-03,2023-09-21,2023-12-11,4365,1199,3166
401242,Client_161,2022-02-22,2022-03-24,2022-06-25,2417,1658,759
401243,Client_162,2022-05-07,2022-06-27,2022-07-07,3558,463,3095
401244,Client_162,2021-05-27,2021-06-12,2021-08-01,15749,7968,7781
401245,Client_162,2022-10-19,2022-12-11,2023-02-02,9940,1622,8318
401246,Client_162,2021-12-02,2022-01-13,2022-02-06,6996,5427,1569
401247,Client_162,2023-09-25,2023-11-21,2024-03-09,16289,10719,5570
401248,Client_162,2021-09-18,2021-11-18,2021-12-12,11054,10049,1005
401249,Client_162,2021-02-05,2021-03-15,2021-05-25,1928,377,1551
401250,Client_162,2022-09-29,2022-12-11,2023-01-23,18745,12222,6523
401251,Client_163,2021-02-05,2021-04-17,2021-06-26,3853,3245,608
401252,Client_163,2021-12-20,2022-03-19,2022-05-30,2912,984,1928
401253,Client_163,2022-10-20,2022-11-04,2023-01-13,3049,1598,1451
401254,Client_163,2022-07-08,2022-08-09,2022-08-28,5955,1094,4861
401255,Client_163,2021-12-30,2022-02-24,2022-03-27,19393,9137,10256
401256,Client_163,2021-11-15,2022-02-05,2022-04-15,11641,6693,4948
401257,Client_163,2022-05-11,2022-05-27,2022-08-20,12708,5033,7675
401258,Client_163,2023-07-11,2023-09-24,2023-11-06,19574,13618,5956
401259,Client_163,2023-03-21,2023-05-18,2023-06-29,4194,2089,2105
401260,Client_163,2021-12-25,2022-02-14,2022-02-21,9892,1771,8121
401261,Client_163,2022-10-17,2022-12-03,2023-02-19,6590,5098,1492
401262,Client_164,2023-01-01,2023-02-17,2023-03-16,10034,2566,7468
401263,Client_164,2023-06-06,2023-08-26,2023-08-27,12980,4,12976
401264,Client_164,2021-02-03,2021-04-13,2021-05-19,17100,6529,10571
401265,Client_164,2022-04-26,2022-06-02,2022-07-07,4986,1563,3423
401266,Client_164,2023-07-10,2023-08-30,2023-09-02,14463,11477,2986
401267,Client_164,2022-06-06,2022-08-25,2022-11-18,14109,4870,9239
401268,Client_164,2022-04-05,2022-06-21,2022-09-13,15717,11577,4140
401269,Client_164,2021-08-26,2021-11-10,2021-12-22,6733,3749,2984
401270,Client_164,2021-04-17,2021-06-29,2021-09-28,3007,926,2081
401271,Client_164,2021-08-10,2021-10-21,2021-10-30,4349,1779,2570
401272,Client_164,2022-02-14,2022-03-02,2022-04-12,1186,756,430
401273,Client_164,2022-03-22,2022-06-10,2022-07-16,14522,2629,11893
401274,Client_164,2021-12-21,2022-01-18,2022-01-19,6459,6147,312
401275,Client_165,2021-03-21,2021-04-22,2021-08-12,17381,13941,3440
401276,Client_165,2021-03-21,2021-04-14,2021-07-07,6460,692,5768
401277,Client_165,2021-05-23,2021-08-17,2021-08-25,16303,9427,6876
401278,Client_165,2022-03-01,2022-04-19,2022-06-13,17896,5467,12429
401279,Client_165,2021-03-05,2021-05-15,2021-08-01,5783,3764,2019
401280,Client_165,2021-11-26,2022-01-21,2022-03-29,11662,11110,552
401281,Client_165,2021-11-18,2022-01-27,2022-05-03,18131,8685,9446
401282,Client_166,2021-01-04,2021-03-30,2021-05-08,9749,577,9172
401283,Client_166,2021-08-02,2021-08-20,2021-10-30,11601,2583,9018
401284,Client_166,2023-06-28,2023-08-16,2023-09-04,16011,3982,12029
401285,Client_166,2021-07-14,2021-07-29,2021-10-11,13297,3064,10233
401286,Client_167,2022-04-12,2022-06-28,2022-10-14,18045,5739,12306
401287,Client_167,2022-07-11,2022-08-27,2022-11-18,3785,474,3311
401288,Client_167,2022-06-22,2022-09-07,2022-09-14,15335,10652,4683
401289,Client_167,2023-01-01,2023-01-22,2023-04-30,13823,3020,10803
401290,Client_167,2023-04-22,2023-06-12,2023-09-25,1726,1168,558
401291,Client_167,2023-09-18,2023-11-15,2023-11-25,15288,3498,11790
401292,Client_168,2021-07-09,2021-08-10,2021-08-15,11276,4800,6476
401293,Client_168,2023-07-26,2023-08-18,2023-10-13,15542,12862,2680
401294,Client_168,2021-08-16,2021-10-02,2021-12-26,2782,2723,59
401295,Client_168,2023-03-15,2023-05-28,2023-07-03,11079,2414,8665
401296,Client_168,2021-11-29,2022-02-20,2022-05-15,18812,1641,17171
401297,Client_168,2021-09-13,2021-09-29,2021-11-25,11977,2094,9883
401298,Client_168,2023-02-05,2023-05-01,2023-07-02,17830,16205,1625
401299,Client_168,2021-02-21,2021-05-09,2021-08-06,11392,11275,117
401300,Client_168,2023-06-09,2023-07-03,2023-07-10,11580,10563,1017
401301,Client_169,2021-02-19,2021-04-23,2021-05-20,9342,802,8540
401302,Client_169,2021-06-10,2021-06-28,2021-06-28,5308,603,4705
401303,Client_169,2022-01-21,2022-03-22,2022-04-24,17569,6522,11047
401304,Client_169,2022-08-21,2022-10-20,2022-12-11,10773,1007,9766
401305,Client_169,2022-10-21,2022-11-20,2023-01-21,8143,5183,2960
401306,Client_170,2023-05-16,2023-08-04,2023-09-13,2731,2629,102
401307,Client_170,2021-09-28,2021-10-31,2021-12-15,13247,1448,11799
401308,Client_171,2023-04-12,2023-06-25,2023-08-10,12104,4564,7540
401309,Client_171,2023-08-22,2023-10-15,2024-02-08,904,835,69
401310,Client_171,2021-08-28,2021-11-25,2022-02-15,19298,1597,17701
401311,Client_172,2022-12-18,2023-01-05,2023-02-21,9369,3489,5880
401312,Client_172,2022-07-21,2022-09-16,2022-09-30,18778,9850,8928
401313,Client_172,2023-06-18,2023-08-11,2023-12-01,17687,4580,13107
401314,Client_172,2023-04-14,2023-07-01,2023-10-22,2187,736,1451
401315,Client_172,2021-02-02,2021-02-20,2021-05-16,11506,11096,410
401316,Client_172,2022-11-27,2023-02-16,2023-03-19,16441,11096,5345
401317,Client_172,2023-07-27,2023-09-10,2023-09-13,4742,1134,3608
401318,Client_172,2021-01-29,2021-04-22,2021-07-14,4162,3578,584
401319,Client_172,2023-01-06,2023-02-11,2023-03-10,2002,389,1613
401320,Client_172,2021-05-10,2021-06-19,2021-09-26,630,63,567
401321,Client_172,2021-01-25,2021-02-24,2021-03-23,2337,1681,656
401322,Client_173,2023-01-31,2023-03-08,2023-06-23,18386,17804,582
401323,Client_173,2023-04-01,2023-05-31,2023-07-25,3372,2301,1071
401324,Client_173,2023-01-31,2023-03-29,2023-05-22,790,167,623
401325,Client_173,2023-08-03,2023-10-12,2024-01-17,17928,4612,13316
401326,Client_173,2021-01-23,2021-04-21,2021-07-01,7184,1075,6109
401327,Client_173,2023-06-22,2023-08-28,2023-11-03,7921,4225,3696
401328,Client_174,2022-09-19,2022-11-03,2022-12-21,1657,161,1496
401329,Client_174,2021-02-25,2021-05-05,2021-08-26,10639,2655,7984
401330,Client_174,2022-06-17,2022-07-11,2022-07-31,12092,8930,3162
401331,Client_175,2021-08-24,2021-10-14,2021-10-17,14578,14379,199
401332,Client_175,2023-09-15,2023-11-21,2024-02-15,4524,2574,1950
401333,Client_175,2021-03-12,2021-04-06,2021-07-14,12073,2605,9468
401334,Client_175,2021-05-06,2021-05-22,2021-08-14,10364,2106,8258
401335,Client_175,2021-10-17,2021-11-13,2022-01-31,16608,10237,6371
401336,Client_175,2021-10-30,2021-11-25,2021-12-13,9313,2664,6649
401337,Client_175,2022-02-01,2022-02-23,2022-04-22,19006,7885,11121
401338,Client_175,2023-07-03,2023-08-15,2023-12-01,3372,2407,965
401339,Client_175,2023-07-03,2023-08-22,2023-09-23,8214,3833,4381
401340,Client_175,2021-11-06,2022-02-02,2022-03-24,13866,5664,8202
401341,Client_175,2022-10-04,2022-12-29,2023-01-06,7227,5977,1250
401342,Client_175,2022-03-05,2022-04-17,2022-05-21,19792,10558,9234
401343,Client_175,2021-12-03,2022-01-07,2022-02-27,4135,1750,2385
401344,Client_176,2022-09-16,2022-10-13,2023-01-20,13191,630,12561
401345,Client_176,2022-12-27,2023-03-26,2023-04-27,7547,1448,6099
401346,Client_176,2021-07-19,2021-10-10,2021-12-01,7142,1050,6092
401347,Client_176,2023-02-15,2023-03-04,2023-03-17,4440,4131,309
401348,Client_176,2022-12-17,2023-01-14,2023-04-25,11932,4250,7682
401349,Client_177,2021-05-12,2021-07-02,2021-08-25,8690,1676,7014
401350,Client_177,2023-06-29,2023-09-08,2023-12-02,11794,1695,10099
401351,Client_177,2021-10-31,2021-12-03,2022-01-13,4180,3646,534
401352,Client_177,2022-05-14,2022-06-18,2022-08-25,16674,11209,5465
401353,Client_177,2021-01-07,2021-02-27,2021-06-25,3731,490,3241
401354,Client_177,2022-08-07,2022-09-06,2022-11-29,2106,1470,636
401355,Client_177,2023-09-03,2023-11-07,2023-12-01,11750,896,10854
401356,Client_177,2021-05-23,2021-07-22,2021-08-23,16710,7214,9496
401357,Client_177,2023-06-12,2023-07-15,2023-10-30,8926,3157,5769
401358,Client_178,2021-11-07,2022-01-20,2022-05-16,2757,2679,78
401359,Client_178,2021-08-04,2021-10-03,2021-12-23,8619,8155,464
401360,Client_178,2023-04-25,2023-07-09,2023-07-21,3436,1568,1868
401361,Client_178,2023-02-04,2023-04-16,2023-08-05,13803,12133,1670
401362,Client_178,2023-02-11,2023-04-21,2023-05-20,13315,3538,9777
401363,Client_178,2022-08-27,2022-11-07,2023-01-15,19993,15203,4790
401364,Client_178,2022-07-31,2022-09-18,2022-12-10,19465,19114,351
401365,Client_179,2021-06-23,2021-09-16,2021-11-14,6985,931,6054
401366,Client_179,2021-02-28,2021-04-20,2021-07-10,12873,4224,8649
401367,Client_179,2021-08-28,2021-09-13,2021-10-03,1279,995,284
401368,Client_179,2021-06-30,2021-08-19,2021-10-21,4206,1688,2518
401369,Client_179,2023-06-07,2023-06-27,2023-10-09,1567,1447,120
401370,Client_179,2021-08-26,2021-10-12,2021-11-28,12055,6245,5810
401371,Client_179,2023-09-06,2023-09-21,2023-12-16,1331,691,640
401372,Client_179,2021-01-19,2021-03-22,2021-05-05,9007,4944,4063
401373,Client_179,2021-10-02,2021-12-10,2022-01-21,4437,3288,1149
401374,Client_179,2022-09-09,2022-12-06,2023-01-17,15428,13361,2067
401375,Client_179,2021-10-24,2022-01-11,2022-02-14,7881,6918,963
401376,Client_180,2023-08-13,2023-10-23,2023-11-04,978,668,310
401377,Client_180,2022-12-25,2023-01-25,2023-04-21,13153,11766,1387
401378,Client_180,2021-03-03,2021-04-13,2021-07-07,15175,3301,11874
401379,Client_180,2023-05-14,2023-06-25,2023-08-22,15766,3612,12154
401380,Client_180,2023-08-05,2023-10-06,2023-11-21,16254,4655,11599
401381,Client_180,2022-07-02,2022-09-19,2022-11-15,14723,3031,11692
401382,Client_180,2022-05-04,2022-06-09,2022-07-03,15698,14087,1611
401383,Client_180,2021-05-14,2021-07-01,2021-10-27,13062,7964,5098
401384,Client_181,2023-01-12,2023-02-25,2023-06-03,980,696,284
401385,Client_181,2022-07-20,2022-10-07,2022-11-27,11579,9306,2273
401386,Client_181,2022-05-31,2022-06-30,2022-10-07,3945,3439,506
401387,Client_181,2023-03-24,2023-06-05,2023-07-04,8518,7078,1440
401388,Client_181,2022-08-15,2022-10-30,2022-11-12,9545,9513,32
401389,Client_181,2023-07-26,2023-09-26,2024-01-11,7601,4861,2740
401390,Client_181,2022-03-05,2022-04-13,2022-06-04,15770,13345,2425
401391,Client_181,2022-03-29,2022-04-30,2022-05-02,3427,835,2592
401392,Client_181,2021-08-19,2021-10-15,2022-01-20,18506,8157,10349
401393,Client_181,2022-05-26,2022-08-23,2022-12-04,572,426,146
401394,Client_182,2022-04-21,2022-05-12,2022-08-06,8183,1063,7120
401395,Client_182,2021-08-25,2021-09-17,2021-11-26,7296,5680,1616
401396,Client_182,2023-09-27,2023-12-01,2023-12-29,11348,952,10396
401397,Client_182,2023-08-01,2023-10-07,2023-11-24,3012,163,2849
401398,Client_182,2021-05-13,2021-08-01,2021-11-04,10102,9056,1046
401399,Client_182,2022-09-03,2022-10-26,2022-11-25,10706,2196,8510
401400,Client_183,2021-09-14,2021-10-05,2022-01-23,10441,35,10406
401401,Client_183,2022-06-14,2022-07-16,2022-10-13,19950,2432,17518
401402,Client_183,2023-01-30,2023-03-26,2023-05-13,18526,14257,4269
401403,Client_183,2023-03-25,2023-05-27,2023-07-31,18091,2265,15826
401404,Client_183,2021-02-08,2021-04-19,2021-07-24,14205,11012,3193
401405,Client_183,2023-04-30,2023-06-05,2023-09-25,7875,4934,2941
401406,Client_183,2022-02-27,2022-03-14,2022-03-16,15471,7273,8198
401407,Client_183,2022-02-01,2022-04-14,2022-08-11,18624,9649,8975
401408,Client_183,2022-03-22,2022-05-09,2022-07-19,2407,1753,654
401409,Client_184,2021-10-01,2021-12-07,2022-01-09,9088,5371,3717
401410,Client_184,2023-02-26,2023-03-17,2023-05-13,18405,11384,7021
401411,Client_184,2022-02-06,2022-05-03,2022-08-21,11228,10328,900
401412,Client_184,2023-02-13,2023-03-09,2023-04-08,17692,2972,14720
401413,Client_184,2022-10-29,2022-12-06,2022-12-22,9387,4702,4685
401414,Client_184,2022-01-18,2022-02-11,2022-04-14,6628,714,5914
401415,Client_184,2023-04-26,2023-06-02,2023-09-09,1431,1245,186
401416,Client_184,2021-12-16,2022-02-05,2022-04-17,658,14,644
401417,Client_184,2021-05-03,2021-05-19,2021-08-08,16214,14610,1604
401418,Client_184,2022-10-02,2022-11-28,2023-03-23,18994,4166,14828
401419,Client_184,2022-05-08,2022-07-12,2022-09-01,13220,5750,7470
401420,Client_184,2022-12-10,2023-02-02,2023-03-16,12424,9270,3154
401421,Client_184,2023-06-29,2023-08-11,2023-12-02,12715,12209,506
401422,Client_185,2021-01-14,2021-03-16,2021-05-10,1979,567,1412
401423,Client_185,2021-12-04,2022-01-22,2022-02-17,7154,2068,5086
401424,Client_185,2022-01-16,2022-02-08,2022-02-17,15224,15202,22
401425,Client_185,2023-09-03,2023-10-09,2023-12-13,16657,8518,8139
401426,Client_186,2023-09-08,2023-11-19,2023-12-21,14697,3746,10951
401427,Client_186,2021-06-17,2021-07-02,2021-07-04,8552,8183,369
401428,Client_186,2023-09-03,2023-10-16,2023-12-25,13390,9648,3742
401429,Client_186,2021-12-15,2022-03-03,2022-04-28,3581,1034,2547
401430,Client_186,2022-06-15,2022-07-08,2022-08-16,10459,9867,592
401431,Client_186,2021-06-03,2021-06-20,2021-09-22,6195,3153,3042
401432,Client_186,2023-05-01,2023-06-20,2023-08-22,7798,7171,627
401433,Client_186,2021-03-07,2021-04-19,2021-04-20,18610,12454,6156
401434,Client_187,2021-04-22,2021-05-08,2021-08-12,12315,10915,1400
401435,Client_187,2023-06-25,2023-07-13,2023-10-11,16690,12179,4511
401436,Client_187,2022-09-29,2022-11-28,2022-12-11,727,602,125
401437,Client_187,2022-07-05,2022-08-14,2022-10-19,12073,2856,9217
401438,Client_187,2022-04-16,2022-07-12,2022-07-19,11935,171,11764
401439,Client_187,2022-10-28,2022-11-15,2023-02-21,19053,5342,13711
401440,Client_187,2021-03-27,2021-04-26,2021-06-22,14578,14455,123
401441,Client_187,2022-06-06,2022-08-08,2022-10-19,2208,1081,1127
401442,Client_187,2022-04-30,2022-06-14,2022-08-13,13200,3497,9703
401443,Client_187,2023-02-21,2023-04-12,2023-08-07,10297,4345,5952
401444,Client_187,2022-04-26,2022-06-23,2022-08-15,12437,485,11952
401445,Client_187,2023-03-25,2023-05-09,2023-05-22,3809,955,2854
401446,Client_187,2021-02-24,2021-03-20,2021-04-01,852,12,840
401447,Client_188,2022-10-27,2022-12-05,2023-01-12,14550,13037,1513
401448,Client_188,2021-06-18,2021-07-20,2021-10-09,17542,15348,2194
401449,Client_188,2022-11-05,2023-01-18,2023-04-24,1143,720,423
401450,Client_188,2022-01-07,2022-03-11,2022-07-08,5672,3776,1896
401451,Client_188,2021-11-29,2022-02-09,2022-06-01,18907,8117,10790
401452,Client_188,2021-05-16,2021-07-24,2021-10-06,13530,157,13373
401453,Client_188,2021-10-18,2021-11-03,2021-12-16,2691,250,2441
401454,Client_188,2022-05-20,2022-06-12,2022-07-27,11743,5398,6345
401455,Client_188,2023-08-14,2023-09-18,2023-09-23,4292,1869,2423
401456,Client_188,2021-03-18,2021-04-23,2021-06-28,3209,2675,534
401457,Client_188,2021-01-10,2021-01-25,2021-05-17,18040,3717,14323
401458,Client_189,2022-04-06,2022-05-06,2022-05-19,14722,6647,8075
401459,Client_189,2022-01-14,2022-02-28,2022-04-21,2388,1606,782
401460,Client_189,2021-08-04,2021-09-24,2021-10-27,7532,5557,1975
401461,Client_189,2021-05-10,2021-06-05,2021-06-12,6860,3224,3636
401462,Client_189,2023-08-27,2023-09-11,2023-11-01,9777,5644,4133
401463,Client_189,2023-02-20,2023-03-11,2023-03-30,5480,1257,4223
401464,Client_189,2021-10-20,2021-11-10,2022-03-07,15805,14318,1487
401465,Client_189,2022-08-17,2022-09-04,2022-11-14,2644,2227,417
401466,Client_189,2021-12-31,2022-01-24,2022-03-10,13197,2174,11023
401467,Client_189,2022-11-25,2022-12-29,2023-01-04,9614,7785,1829
401468,Client_189,2022-05-31,2022-06-21,2022-10-04,14114,1773,12341
401469,Client_190,2021-04-01,2021-06-23,2021-09-16,4350,2217,2133
401470,Client_190,2021-10-04,2021-11-17,2021-12-03,9855,3630,6225
401471,Client_190,2022-10-06,2022-12-12,2023-01-09,14063,8761,5302
401472,Client_190,2023-03-04,2023-03-30,2023-07-08,12744,5524,7220
401473,Client_190,2021-12-27,2022-01-13,2022-01-13,16504,6490,10014
401474,Client_190,2021-08-24,2021-09-13,2021-10-28,4492,550,3942
401475,Client_190,2021-08-01,2021-10-28,2021-12-05,18227,17518,709
401476,Client_190,2021-11-11,2022-01-06,2022-03-29,7555,5046,2509
401477,Client_190,2021-07-15,2021-10-02,2021-10-27,9607,2239,7368
401478,Client_190,2021-02-11,2021-03-28,2021-04-28,12944,3060,9884
401479,Client_190,2022-12-12,2023-02-04,2023-04-23,15657,5048,10609
401480,Client_190,2022-01-26,2022-04-22,2022-07-05,16909,8249,8660
401481,Client_190,2021-07-21,2021-09-27,2021-11-25,7601,5113,2488
401482,Client_190,2021-02-04,2021-03-24,2021-06-12,15866,14406,1460
401483,Client_191,2022-10-28,2022-12-04,2022-12-07,3454,3408,46
401484,Client_191,2023-03-07,2023-04-20,2023-08-13,14905,6590,8315
401485,Client_191,2022-04-30,2022-07-20,2022-08-20,16251,12844,3407
401486,Client_191,2022-11-06,2022-12-31,2023-01-24,17249,10385,6864
401487,Client_191,2021-08-25,2021-10-21,2021-12-03,4991,2537,2454
401488,Client_191,2022-12-13,2023-03-07,2023-04-03,8985,4514,4471
401489,Client_191,2023-05-21,2023-08-11,2023-09-25,15060,3833,11227
401490,Client_191,2023-01-26,2023-03-22,2023-07-02,9934,8489,1445
401491,Client_191,2022-09-24,2022-12-19,2023-01-09,14480,13514,966
401492,Client_191,2021-01-04,2021-03-07,2021-06-04,15013,13633,1380
401493,Client_192,2023-08-07,2023-09-15,2024-01-02,5938,3058,2880
401494,Client_193,2023-09-12,2023-10-14,2023-11-22,19768,16689,3079
401495,Client_193,2022-04-10,2022-05-11,2022-08-31,4526,865,3661
401496,Client_193,2022-08-09,2022-09-11,2022-12-19,10769,850,9919
401497,Client_193,2021-08-10,2021-09-30,2022-01-11,8633,220,8413
401498,Client_193,2023-09-11,2023-10-03,2024-01-15,3801,2604,1197
401499,Client_193,2021-06-08,2021-07-14,2021-07-28,12980,2540,10440
401500,Client_193,2023-01-12,2023-04-04,2023-06-21,10102,5639,4463
401501,Client_193,2022-03-15,2022-05-18,2022-06-07,19703,11594,8109
401502,Client_193,2021-08-04,2021-09-06,2021-10-26,10795,1400,9395
401503,Client_193,2022-10-27,2022-12-30,2023-02-22,9199,2161,7038
401504,Client_193,2023-04-03,2023-06-11,2023-07-18,9678,4627,5051
401505,Client_193,2022-12-24,2023-03-05,2023-05-05,11934,930,11004
401506,Client_194,2023-06-12,2023-07-29,2023-08-20,19997,16416,3581
401507,Client_194,2021-03-21,2021-05-10,2021-05-17,7284,1719,5565
401508,Client_194,2023-04-16,2023-06-21,2023-10-06,1360,837,523
401509,Client_194,2021-12-14,2022-01-25,2022-03-04,10096,4636,5460
401510,Client_194,2022-09-15,2022-11-05,2023-02-09,8257,393,7864
401511,Client_194,2022-08-31,2022-10-24,2022-11-27,14840,9577,5263
401512,Client_194,2021-02-25,2021-05-04,2021-08-06,7934,724,7210
401513,Client_194,2023-02-06,2023-04-13,2023-07-05,2398,980,1418
401514,Client_194,2022-05-16,2022-06-14,2022-07-26,2590,700,1890
401515,Client_194,2022-05-02,2022-07-14,2022-09-25,9579,6499,3080
401516,Client_194,2023-08-29,2023-11-10,2023-11-16,5872,1479,4393
401517,Client_195,2023-02-12,2023-05-10,2023-08-22,15855,2071,13784
401518,Client_195,2021-08-17,2021-11-05,2022-01-07,17415,15442,1973
401519,Client_195,2023-08-31,2023-10-17,2023-12-22,716,557,159
401520,Client_195,2022-01-11,2022-02-03,2022-05-18,920,839,81
401521,Client_195,2021-09-08,2021-11-26,2022-01-17,16142,6119,10023
401522,Client_195,2023-06-24,2023-08-22,2023-09-23,4291,1873,2418
401523,Client_195,2023-07-06,2023-08-03,2023-11-12,8813,8432,381
401524,Client_195,2021-09-29,2021-10-26,2022-01-20,9601,7170,2431
401525,Client_195,2021-10-22,2021-12-05,2022-03-02,10217,857,9360
401526,Client_195,2021-07-17,2021-09-26,2022-01-17,12586,11171,1415
401527,Client_195,2021-07-02,2021-07-29,2021-09-09,11563,4593,6970
401528,Client_195,2021-11-10,2021-12-17,2021-12-17,6046,259,5787
401529,Client_195,2021-05-15,2021-06-07,2021-06-18,13047,6973,6074
401530,Client_195,2023-02-18,2023-03-19,2023-06-16,16113,1789,14324
401531,Client_196,2021-09-15,2021-12-09,2022-01-17,10796,1764,9032
401532,Client_196,2022-07-09,2022-08-01,2022-09-25,3404,3163,241
401533,Client_196,2023-02-15,2023-03-08,2023-05-11,18925,15812,3113
401534,Client_196,2021-04-18,2021-06-10,2021-07-08,6717,4626,2091
401535,Client_196,2022-03-23,2022-05-12,2022-06-12,7627,4139,3488
401536,Client_196,2021-08-05,2021-10-07,2022-01-17,7607,798,6809
401537,Client_196,2023-03-01,2023-04-07,2023-06-18,10154,9443,711
401538,Client_196,2021-01-29,2021-03-10,2021-04-22,8815,6374,2441
401539,Client_196,2023-08-25,2023-10-02,2024-01-27,1197,710,487
401540,Client_196,2021-01-26,2021-04-13,2021-06-29,6636,2892,3744
401541,Client_196,2022-11-11,2022-12-09,2023-02-24,15102,11172,3930
401542,Client_197,2022-10-11,2022-11-05,2023-01-15,19568,16660,2908
401543,Client_197,2022-04-30,2022-05-27,2022-07-06,1948,1800,148
401544,Client_198,2022-05-14,2022-06-17,2022-08-24,14113,12304,1809
401545,Client_198,2022-06-02,2022-07-30,2022-10-30,16276,7950,8326
401546,Client_198,2023-01-26,2023-03-10,2023-06-26,3602,3104,498
401547,Client_198,2021-07-16,2021-09-30,2021-12-20,5158,1934,3224
401548,Client_198,2022-05-06,2022-06-22,2022-09-02,13713,747,12966
401549,Client_198,2022-12-01,2023-02-26,2023-03-27,13351,8568,4783
401550,Client_198,2022-07-14,2022-09-28,2022-12-21,14738,11083,3655
401551,Client_199,2022-08-18,2022-09-16,2022-10-14,4432,1466,2966
401552,Client_199,2021-01-16,2021-03-16,2021-03-19,9332,3817,5515
401553,Client_199,2021-01-28,2021-04-08,2021-04-28,10527,3771,6756
401554,Client_199,2021-06-03,2021-07-07,2021-08-25,15298,13587,1711
401555,Client_199,2023-07-24,2023-08-17,2023-11-20,14296,9243,5053
401556,Client_199,2023-09-13,2023-11-27,2024-01-10,10559,2328,8231
401557,Client_200,2022-12-17,2023-01-24,2023-04-03,12112,1861,10251
401558,Client_200,2022-02-16,2022-04-23,2022-08-04,12106,6368,5738
401559,Client_200,2022-06-30,2022-07-25,2022-07-27,19593,14227,5366
401560,Client_200,2022-11-13,2023-02-01,2023-05-24,18322,10188,8134
401561,Client_200,2023-08-10,2023-09-27,2023-10-16,15962,13716,2246
401562,Client_200,2022-11-27,2022-12-22,2023-04-13,18676,13235,5441
401563,Client_200,2021-03-29,2021-05-10,2021-06-09,3311,1480,1831
401564,Client_200,2022-07-28,2022-10-06,2023-01-13,8599,5961,2638
401565,Client_200,2021-10-05,2021-12-18,2022-03-28,5718,674,5044
401566,Client_200,2021-12-22,2022-01-09,2022-03-28,6344,5013,1331
401567,Client_200,2022-08-03,2022-10-04,2022-12-07,4945,361,4584
401568,Client_200,2022-06-01,2022-08-18,2022-10-02,5948,5289,659
401569,Client_200,2021-09-23,2021-10-28,2021-12-06,8879,2568,6311
