id_facture,nom_du_client,create_date,due_in_date,clear_date,montant_totale,totale_payer,totale_reste
100001,Alpha Co 1,2023-08-19,2023-09-15,2023-11-11,3596,619,2977
100002,Alpha Co 1,2023-09-08,2023-10-23,2023-12-26,2834,238,2596
100003,Alpha Co 1,2024-04-11,2024-05-22,2024-12-01,3777,119,3658
100004,Alpha Co 1,2023-07-19,2023-09-17,2024-03-07,4827,327,4500
100005,Alpha Co 1,2024-02-14,2024-03-15,2024-05-01,2719,468,2251
100006,Alpha Co 1,2025-07-03,2025-07-24,2025-11-03,2719,142,2577
100007,Alpha Co 1,2023-06-30,2023-08-28,2023-10-25,4895,497,4398
100008,Alpha Co 1,2024-07-24,2024-08-23,2024-11-08,3920,101,3819
100009,Alpha Co 1,2024-04-12,2024-05-05,2024-11-02,2436,116,2320
100010,Alpha Co 1,2024-07-26,2024-09-17,2025-02-23,3651,510,3141
100011,Alpha Co 1,2024-09-19,2024-11-05,2025-05-10,2443,291,2152
100012,Alpha Co 1,2024-04-01,2024-04-26,2024-10-10,2441,143,2298
100013,Alpha Co 1,2024-04-05,2024-05-06,2024-08-30,3290,188,3102
100014,Alpha Co 1,2025-02-23,2025-04-12,2025-07-28,704,76,628
100015,Alpha Co 1,2023-10-09,2023-11-21,2024-03-19,930,172,758
100016,Alpha Co 1,2023-08-29,2023-09-30,2024-04-01,2325,317,2008
100017,Alpha Co 1,2023-03-24,2023-04-16,2023-09-07,1784,306,1478
100018,Alpha Co 1,2024-12-11,2025-01-04,2025-03-07,3377,222,3155
100019,Alpha Co 1,2024-02-29,2024-04-10,2024-09-22,1910,262,1648
100020,Alpha Co 1,2024-03-01,2024-03-19,2024-08-19,1305,210,1095
100021,Alpha Co 1,2024-02-03,2024-03-26,2024-05-16,4758,96,4662
100022,Alpha Co 1,2025-05-27,2025-07-17,2025-09-02,2729,349,2380
100023,Alpha Co 1,2025-08-23,2025-09-29,2026-02-21,3081,441,2640
100024,Alpha Co 1,2025-05-23,2025-07-03,2026-01-04,1290,126,1164
100025,Alpha Co 1,2025-03-30,2025-05-22,2025-11-08,2346,69,2277
100026,Alpha Co 1,2023-08-13,2023-09-14,2023-11-06,3133,367,2766
100027,Alpha Co 1,2024-02-03,2024-03-10,2024-08-06,1618,118,1500
100028,Alpha Co 1,2025-01-11,2025-02-05,2025-04-24,3450,139,3311
100029,Alpha Co 1,2024-09-29,2024-11-17,2025-04-12,2279,444,1835
100030,Alpha Co 1,2024-08-29,2024-10-19,2024-12-25,2649,196,2453
100031,Alpha Co 1,2024-10-20,2024-12-01,2025-05-14,2277,397,1880
100032,Alpha Co 1,2023-07-06,2023-07-24,2023-11-30,5222,786,4436
100033,Alpha Co 1,2023-08-05,2023-09-18,2024-02-08,2983,411,2572
100034,Alpha Co 1,2023-10-12,2023-11-22,2024-01-27,1730,263,1467
100035,Nu Trading 159,2023-01-20,2023-03-10,2023-07-23,3987,758,3229
100036,Nu Trading 159,2023-08-18,2023-10-13,2023-12-08,1534,287,1247
100037,Nu Trading 159,2025-02-11,2025-02-27,2025-06-04,3250,64,3186
100038,Nu Trading 159,2025-05-09,2025-05-25,2025-09-09,648,53,595
100039,Nu Trading 159,2023-05-10,2023-06-24,2023-12-31,1406,102,1304
100040,Nu Trading 159,2025-08-28,2025-09-25,2026-01-14,3236,361,2875
100041,Nu Trading 159,2025-02-24,2025-04-03,2025-06-17,3886,653,3233
100042,Nu Trading 159,2025-03-07,2025-04-01,2025-06-13,3205,54,3151
100043,Nu Trading 159,2024-08-15,2024-08-31,2025-03-12,2861,67,2794
100044,Nu Trading 159,2024-11-24,2025-01-02,2025-04-08,2638,329,2309
100045,Nu Trading 159,2023-03-19,2023-05-10,2023-08-26,1225,84,1141
100046,Nu Trading 159,2023-04-15,2023-06-13,2023-12-29,2136,114,2022
100047,Nu Trading 159,2025-04-04,2025-04-26,2025-11-02,2447,119,2328
100048,Nu Trading 159,2025-03-12,2025-03-29,2025-08-31,4268,572,3696
100049,Nu Trading 159,2024-11-08,2024-12-16,2025-04-28,3412,638,2774
100050,Nu Trading 159,2023-01-13,2023-02-23,2023-05-07,884,39,845
100051,Nu Trading 159,2024-03-19,2024-04-26,2024-10-06,3388,268,3120
100052,Nu Trading 159,2024-12-25,2025-01-18,2025-07-16,2537,297,2240
100053,Nu Trading 159,2024-10-28,2024-11-29,2025-05-31,2187,181,2006
100054,Nu Trading 159,2025-03-04,2025-04-18,2025-11-01,3734,417,3317
100055,Nu Trading 159,2023-10-02,2023-11-06,2024-01-13,4237,162,4075
100056,Nu Trading 159,2023-10-13,2023-11-25,2024-05-07,4117,633,3484
100057,Nu Trading 159,2024-08-06,2024-09-29,2025-02-08,1992,146,1846
100058,Nu Trading 159,2023-01-30,2023-03-17,2023-06-17,2628,101,2527
100059,Nu Trading 159,2024-05-14,2024-06-11,2024-10-01,3397,450,2947
100060,Nu Trading 159,2023-12-15,2024-01-16,2024-05-11,4170,137,4033
100061,Nu Trading 159,2024-07-23,2024-08-07,2024-11-09,2424,247,2177
100062,Nu Trading 159,2023-03-29,2023-04-28,2023-10-16,2777,175,2602
100063,Nu Trading 159,2024-07-22,2024-08-21,2025-02-08,1672,115,1557
100064,Nu Trading 159,2024-04-03,2024-04-19,2024-07-30,1564,285,1279
100065,Nu Trading 159,2024-02-19,2024-04-18,2024-10-29,3975,611,3364
100066,Nu Trading 159,2024-01-13,2024-02-27,2024-07-10,4627,439,4188
100067,Nu Trading 159,2024-03-11,2024-04-30,2024-10-09,2913,400,2513
100068,Nu Trading 159,2023-10-05,2023-11-08,2024-01-23,4204,640,3564
100069,Nu Trading 159,2025-01-08,2025-02-04,2025-08-06,3433,481,2952
100070,Nu Trading 159,2025-08-31,2025-10-29,2026-02-07,2225,367,1858
100071,Nu Trading 159,2025-01-26,2025-03-12,2025-09-24,3433,506,2927
100072,Nu Trading 159,2025-02-17,2025-04-06,2025-06-16,4845,420,4425
100073,Nu Trading 159,2025-05-02,2025-05-29,2025-10-14,2957,425,2532
100074,Nu Trading 159,2023-07-03,2023-08-06,2024-02-04,4877,962,3915
100075,Upsilon Enterprises 92,2023-10-08,2023-10-25,2024-04-29,50,1,49
100076,Upsilon Enterprises 92,2023-10-27,2023-12-25,2024-06-13,3986,82,3904
100077,Upsilon Enterprises 92,2023-04-16,2023-05-01,2023-10-14,3104,282,2822
100078,Upsilon Enterprises 92,2024-05-05,2024-06-17,2024-08-15,2641,357,2284
100079,Upsilon Enterprises 92,2023-09-16,2023-10-31,2024-01-01,3110,555,2555
100080,Upsilon Enterprises 92,2024-02-15,2024-04-01,2024-05-30,614,114,500
100081,Upsilon Enterprises 92,2023-06-05,2023-06-29,2023-10-30,2736,126,2610
100082,Upsilon Enterprises 92,2023-03-29,2023-04-28,2023-09-27,3428,608,2820
100083,Upsilon Enterprises 92,2024-09-12,2024-11-04,2025-02-15,4773,238,4535
100084,Upsilon Enterprises 92,2025-03-05,2025-04-22,2025-09-28,2378,304,2074
100085,Upsilon Enterprises 92,2023-11-01,2023-12-23,2024-04-25,2029,24,2005
100086,Upsilon Enterprises 92,2024-08-05,2024-09-28,2024-12-08,2397,452,1945
100087,Upsilon Enterprises 92,2025-08-28,2025-09-25,2026-01-16,4098,333,3765
100088,Upsilon Enterprises 92,2024-11-07,2024-11-27,2025-02-25,3394,578,2816
100089,Upsilon Enterprises 92,2024-07-19,2024-08-07,2025-01-04,2364,402,1962
100090,Upsilon Enterprises 92,2024-04-06,2024-06-04,2024-10-02,3615,315,3300
100091,Upsilon Enterprises 92,2023-02-03,2023-03-04,2023-06-30,3116,453,2663
100092,Upsilon Enterprises 92,2024-12-20,2025-02-02,2025-05-18,4162,776,3386
100093,Upsilon Enterprises 92,2025-08-04,2025-09-04,2026-03-19,2157,109,2048
100094,Upsilon Enterprises 92,2024-11-08,2024-12-05,2025-06-08,2606,311,2295
100095,Upsilon Enterprises 92,2023-08-19,2023-10-14,2024-02-05,2529,434,2095
100096,Upsilon Enterprises 92,2025-04-26,2025-05-20,2025-08-16,1243,232,1011
100097,Upsilon Enterprises 92,2025-03-22,2025-04-25,2025-11-02,3355,292,3063
100098,Upsilon Enterprises 92,2025-08-01,2025-09-03,2026-02-15,3313,386,2927
100099,Upsilon Enterprises 92,2024-12-06,2025-01-09,2025-05-04,3006,202,2804
100100,Upsilon Enterprises 92,2024-05-27,2024-07-15,2024-09-19,2718,289,2429
100101,Upsilon Enterprises 92,2024-09-04,2024-09-21,2025-01-27,1301,40,1261
100102,Upsilon Enterprises 92,2024-09-10,2024-10-11,2025-01-23,2495,487,2008
100103,Upsilon Enterprises 92,2024-11-21,2025-01-11,2025-03-03,2588,229,2359
100104,Theta Import 133,2024-08-13,2024-08-30,2024-11-06,2037,276,1761
100105,Theta Import 133,2024-04-26,2024-06-13,2024-09-02,2806,427,2379
100106,Theta Import 133,2023-07-05,2023-08-26,2024-01-23,3484,643,2841
100107,Theta Import 133,2024-05-18,2024-06-07,2024-09-13,5263,945,4318
100108,Theta Import 133,2023-12-08,2024-01-12,2024-03-18,3209,480,2729
100109,Theta Import 133,2023-12-04,2024-01-14,2024-04-05,3309,483,2826
100110,Theta Import 133,2024-11-09,2024-12-19,2025-04-14,2910,372,2538
100111,Theta Import 133,2023-02-07,2023-03-23,2023-06-09,697,165,532
100112,Theta Import 133,2023-11-28,2023-12-20,2024-03-26,2968,310,2658
100113,Theta Import 133,2025-06-04,2025-07-21,2025-09-05,3072,388,2684
100114,Tau Import 132,2024-04-18,2024-05-29,2024-09-18,5955,1440,4515
100115,Tau Import 132,2024-01-06,2024-02-29,2024-07-04,2769,378,2391
100116,Tau Import 132,2024-03-28,2024-04-15,2024-08-09,3361,738,2623
100117,Tau Import 132,2023-05-15,2023-06-17,2023-10-30,2958,545,2413
100118,Tau Import 132,2024-05-11,2024-06-02,2024-10-06,1597,392,1205
100119,Tau Import 132,2024-09-15,2024-10-15,2025-01-08,4371,627,3744
100120,Tau Import 132,2024-07-18,2024-08-02,2024-09-28,3902,652,3250
100121,Tau Import 132,2023-08-19,2023-09-10,2023-11-10,3949,714,3235
100122,Tau Import 132,2024-10-25,2024-11-18,2025-04-04,1908,334,1574
100123,Tau Import 132,2023-10-26,2023-12-12,2024-03-20,4683,675,4008
100124,Tau Import 132,2025-05-04,2025-06-18,2025-09-03,1317,136,1181
100125,Tau Import 132,2024-04-12,2024-06-01,2024-08-10,3704,846,2858
100126,Tau Import 132,2025-08-01,2025-09-23,2025-11-25,5628,978,4650
100127,Tau Import 132,2025-06-03,2025-06-22,2025-11-16,1811,378,1433
100128,Gamma Enterprises 36,2023-12-15,2024-01-31,2024-03-17,2320,487,1833
100129,Gamma Enterprises 36,2023-10-17,2023-11-20,2024-03-19,3119,388,2731
100130,Gamma Enterprises 36,2024-11-06,2024-12-22,2025-04-04,2395,288,2107
100131,Gamma Enterprises 36,2024-07-05,2024-08-19,2024-12-13,1139,226,913
100132,Gamma Enterprises 36,2025-02-20,2025-04-10,2025-07-06,3082,596,2486
100133,Gamma Enterprises 36,2025-06-09,2025-07-06,2025-09-20,1725,177,1548
100134,Gamma Enterprises 36,2024-08-08,2024-09-16,2025-02-08,3568,767,2801
100135,Gamma Enterprises 36,2024-02-25,2024-03-13,2024-06-27,1896,384,1512
100136,Gamma Enterprises 36,2024-12-23,2025-01-31,2025-06-10,4859,933,3926
100137,Gamma Enterprises 36,2025-03-22,2025-05-17,2025-09-03,2060,212,1848
100138,Gamma Enterprises 36,2023-02-07,2023-03-02,2023-07-01,2613,456,2157
100139,Gamma Enterprises 36,2023-12-06,2023-12-27,2024-04-07,3976,473,3503
100140,Zeta Solutions 107,2024-06-22,2024-08-05,2024-10-08,1522,377,1145
100141,Zeta Solutions 107,2024-02-24,2024-04-20,2024-06-14,3272,342,2930
100142,Zeta Solutions 107,2024-04-25,2024-05-26,2024-10-07,4568,910,3658
100143,Zeta Solutions 107,2024-02-12,2024-04-08,2024-07-05,1071,255,816
100144,Zeta Solutions 107,2025-05-22,2025-07-19,2025-10-21,3221,390,2831
100145,Zeta Solutions 107,2023-11-21,2024-01-15,2024-06-06,3311,471,2840
100146,Zeta Solutions 107,2024-05-14,2024-07-02,2024-08-25,3938,963,2975
100147,Omicron SARL 61,2024-10-08,2024-12-05,2025-02-18,1515,169,1346
100148,Omicron SARL 61,2025-02-03,2025-02-23,2025-04-22,1415,262,1153
100149,Omicron SARL 61,2025-02-17,2025-04-13,2025-06-10,3626,524,3102
100150,Omicron SARL 61,2024-03-30,2024-04-24,2024-06-12,3356,490,2866
100151,Omicron SARL 61,2023-02-17,2023-03-24,2023-06-15,3300,431,2869
100152,Omicron SARL 61,2024-01-03,2024-02-10,2024-04-27,3415,633,2782
100153,Omicron SARL 61,2024-06-27,2024-08-07,2025-01-01,2183,360,1823
100154,Omicron SARL 61,2023-07-04,2023-07-29,2023-11-30,3278,733,2545
100155,Omicron SARL 61,2025-06-10,2025-07-19,2025-10-03,3351,526,2825
100156,Xi Tech 74,2025-07-23,2025-09-13,2025-12-27,2142,490,1652
100157,Xi Tech 74,2024-10-15,2024-11-15,2025-03-26,5238,948,4290
100158,Xi Tech 74,2023-01-10,2023-02-23,2023-07-05,3568,410,3158
100159,Xi Tech 74,2024-07-13,2024-08-07,2024-11-05,1570,375,1195
100160,Xi Tech 74,2024-08-24,2024-09-27,2025-01-05,3787,584,3203
100161,Xi Tech 74,2024-12-07,2025-01-07,2025-04-01,1830,332,1498
100162,Xi Tech 74,2023-07-23,2023-08-31,2023-10-29,3944,481,3463
100163,Xi Tech 74,2023-08-31,2023-10-09,2024-02-05,4390,721,3669
100164,Xi Tech 74,2023-10-30,2023-12-28,2024-05-06,2015,415,1600
100165,Xi Tech 74,2024-02-10,2024-03-13,2024-07-24,4156,1034,3122
100166,Xi Tech 74,2025-03-07,2025-03-25,2025-08-13,3495,396,3099
100167,Xi Tech 74,2024-05-23,2024-06-25,2024-09-08,3986,533,3453
100168,Xi Tech 74,2024-09-13,2024-10-20,2024-12-29,5276,1146,4130
100169,Tau Co 57,2024-11-25,2025-01-21,2025-04-12,2705,1568,1137
100170,Tau Co 57,2024-10-05,2024-10-26,2024-12-21,2095,1098,997
100171,Tau Co 57,2023-11-13,2023-12-26,2024-05-13,1932,1433,499
100172,Tau Co 57,2025-01-19,2025-02-11,2025-06-12,2021,1470,551
100173,Tau Co 57,2023-12-01,2024-01-11,2024-03-30,2907,2053,854
100174,Tau Co 57,2025-03-16,2025-05-04,2025-09-20,3409,1810,1599
100175,Tau Co 57,2024-06-27,2024-08-13,2024-11-09,3332,1738,1594
100176,Tau Co 57,2023-09-21,2023-11-05,2024-03-05,3992,2029,1963
100177,Tau Co 57,2025-02-03,2025-03-11,2025-08-23,3015,1655,1360
100178,Tau Co 57,2023-03-19,2023-04-12,2023-07-24,4744,2664,2080
100179,Tau Co 57,2025-05-30,2025-07-27,2025-12-21,2682,1526,1156
100180,Tau Co 57,2025-05-16,2025-07-05,2025-11-29,6264,4125,2139
100181,Tau Co 57,2023-01-15,2023-02-15,2023-07-27,3750,2309,1441
100182,Tau Co 57,2024-01-13,2024-03-11,2024-07-02,1971,1109,862
100183,Tau Co 57,2024-08-21,2024-09-29,2025-02-17,1714,933,781
100184,Tau Co 57,2023-04-21,2023-06-18,2023-08-09,3578,2474,1104
100185,Tau Co 57,2024-09-26,2024-11-15,2025-02-25,2731,1824,907
100186,Tau Co 57,2024-10-25,2024-11-13,2025-04-26,3856,2279,1577
100187,Tau Co 57,2025-07-20,2025-09-17,2026-02-14,3567,2406,1161
100188,Tau Co 57,2023-04-30,2023-05-23,2023-07-17,2912,2151,761
100189,Tau Co 57,2023-11-08,2023-12-24,2024-04-08,1983,1430,553
100190,Tau Co 57,2025-06-27,2025-08-15,2026-01-24,1182,846,336
100191,Tau Co 57,2024-01-15,2024-03-12,2024-09-12,2464,1263,1201
100192,Tau Co 57,2024-03-05,2024-04-26,2024-07-20,4027,2273,1754
100193,Tau Co 57,2025-06-25,2025-08-05,2026-01-23,3256,1909,1347
100194,Tau Co 57,2024-09-22,2024-11-02,2025-02-27,1505,775,730
100195,Chi Industries 191,2024-12-07,2025-01-14,2025-06-22,3207,2231,976
100196,Chi Industries 191,2025-08-31,2025-09-30,2025-12-10,3462,1856,1606
100197,Chi Industries 191,2024-12-03,2025-01-10,2025-05-27,1939,1190,749
100198,Chi Industries 191,2023-03-04,2023-04-13,2023-06-29,3184,2168,1016
100199,Chi Industries 191,2025-08-29,2025-10-12,2026-01-20,3069,2231,838
100200,Chi Industries 191,2024-10-19,2024-12-13,2025-02-02,1628,978,650
100201,Chi Industries 191,2023-02-21,2023-03-29,2023-06-15,3429,2363,1066
100202,Chi Industries 191,2025-03-16,2025-05-06,2025-11-09,3672,2566,1106
100203,Chi Industries 191,2023-08-01,2023-09-22,2024-01-05,4299,2992,1307
100204,Chi Industries 191,2023-12-03,2023-12-27,2024-07-12,4264,2357,1907
100205,Chi Industries 191,2023-01-03,2023-02-04,2023-04-28,1346,721,625
100206,Chi Industries 191,2023-05-14,2023-07-02,2023-09-30,1874,1288,586
100207,Chi Industries 191,2023-04-23,2023-06-19,2023-09-06,3618,1930,1688
100208,Chi Industries 191,2023-01-16,2023-02-22,2023-06-08,3616,1998,1618
100209,Chi Industries 191,2024-08-25,2024-09-29,2025-01-20,3618,2699,919
100210,Chi Industries 191,2023-02-23,2023-03-18,2023-09-14,7623,4304,3319
100211,Chi Industries 191,2023-04-27,2023-05-16,2023-10-01,3685,2325,1360
100212,Chi Industries 191,2024-06-09,2024-07-31,2025-01-21,4362,3153,1209
100213,Chi Industries 191,2023-08-15,2023-10-08,2024-04-04,4144,3063,1081
100214,Xi Enterprises 15,2024-04-14,2024-06-09,2024-08-09,3781,1925,1856
100215,Xi Enterprises 15,2024-05-05,2024-06-14,2024-08-26,2621,1686,935
100216,Xi Enterprises 15,2024-05-17,2024-07-16,2024-09-18,3910,2043,1867
100217,Xi Enterprises 15,2025-07-09,2025-07-29,2025-10-20,2072,1387,685
100218,Xi Enterprises 15,2023-03-09,2023-04-01,2023-10-13,2715,1850,865
100219,Xi Enterprises 15,2024-07-15,2024-09-13,2025-03-30,2417,1616,801
100220,Xi Enterprises 15,2024-06-27,2024-07-30,2025-02-15,3098,1972,1126
100221,Xi Enterprises 15,2024-03-16,2024-04-06,2024-06-20,5777,3187,2590
100222,Xi Enterprises 15,2025-05-23,2025-07-18,2026-01-21,759,446,313
100223,Xi Enterprises 15,2025-01-08,2025-02-05,2025-05-20,3823,2456,1367
100224,Xi Enterprises 15,2024-02-28,2024-04-04,2024-08-30,1064,578,486
100225,Xi Enterprises 15,2024-03-01,2024-03-22,2024-07-26,2433,1635,798
100226,Xi Enterprises 15,2024-11-12,2024-12-13,2025-03-08,4306,2827,1479
100227,Xi Enterprises 15,2024-12-04,2025-01-18,2025-03-26,3077,2256,821
100228,Xi Enterprises 15,2023-04-06,2023-05-18,2023-10-06,1706,1238,468
100229,Xi Enterprises 15,2025-04-11,2025-05-04,2025-11-16,2141,1308,833
100230,Xi Enterprises 15,2024-07-29,2024-09-17,2024-12-03,3815,2547,1268
100231,Xi Enterprises 15,2024-02-25,2024-04-02,2024-09-03,2123,1129,994
100232,Xi Enterprises 15,2025-06-07,2025-06-25,2026-01-10,3259,1655,1604
100233,Xi Enterprises 15,2023-11-16,2023-12-23,2024-06-15,3054,2211,843
100234,Xi Enterprises 15,2023-08-06,2023-08-30,2023-12-11,2218,1299,919
100235,Xi Enterprises 15,2025-05-17,2025-06-07,2025-12-12,5572,3691,1881
100236,Xi Enterprises 15,2024-01-12,2024-02-03,2024-08-13,3760,2103,1657
100237,Xi Enterprises 15,2023-08-20,2023-10-01,2024-04-06,569,307,262
100238,Xi Enterprises 15,2023-01-27,2023-03-21,2023-07-13,3223,1669,1554
100239,Xi Enterprises 15,2023-01-30,2023-02-25,2023-06-30,2205,1503,702
100240,Xi Enterprises 15,2025-08-01,2025-09-06,2025-12-07,4022,2664,1358
100241,Rho Solutions 198,2024-08-02,2024-09-28,2024-12-19,2048,1331,717
100242,Rho Solutions 198,2025-01-28,2025-03-24,2025-06-01,2862,1451,1411
100243,Rho Solutions 198,2025-02-03,2025-03-23,2025-08-23,3605,2510,1095
100244,Rho Solutions 198,2024-04-09,2024-05-15,2024-09-17,4038,2870,1168
100245,Rho Solutions 198,2025-01-08,2025-02-12,2025-08-22,1559,866,693
100246,Rho Solutions 198,2024-09-02,2024-09-22,2024-12-16,2598,1375,1223
100247,Rho Solutions 198,2023-06-11,2023-08-04,2023-10-09,2430,1792,638
100248,Rho Solutions 198,2023-10-06,2023-11-18,2024-05-06,2216,1295,921
100249,Rho Solutions 198,2024-09-13,2024-10-26,2025-02-04,5118,3309,1809
100250,Rho Solutions 198,2025-02-12,2025-03-31,2025-09-03,3485,2515,970
100251,Rho Solutions 198,2023-04-24,2023-05-27,2023-12-10,1486,863,623
100252,Rho Solutions 198,2024-05-13,2024-06-30,2024-08-26,4101,2392,1709
100253,Rho Solutions 198,2023-08-14,2023-09-23,2023-11-22,5546,2795,2751
100254,Rho Solutions 198,2023-01-08,2023-02-05,2023-05-16,4238,2859,1379
100255,Rho Solutions 198,2025-02-24,2025-03-19,2025-07-17,1176,657,519
100256,Rho Solutions 198,2023-12-02,2023-12-24,2024-05-28,2418,1809,609
100257,Rho Solutions 198,2023-06-29,2023-07-22,2023-11-03,4520,2960,1560
100258,Rho Solutions 198,2024-05-27,2024-07-16,2024-11-29,2150,1165,985
100259,Rho Solutions 198,2023-03-15,2023-04-24,2023-06-19,3532,1888,1644
100260,Rho Solutions 198,2024-03-22,2024-04-07,2024-06-11,3929,2495,1434
100261,Rho Solutions 198,2025-06-01,2025-07-06,2026-01-14,1887,1144,743
100262,Rho Solutions 198,2024-02-19,2024-04-19,2024-08-17,2928,1727,1201
100263,Tau Group 66,2024-02-19,2024-03-06,2024-06-03,50,25,25
100264,Tau Group 66,2025-03-31,2025-05-24,2025-10-09,1770,1124,646
100265,Tau Group 66,2023-04-01,2023-05-13,2023-08-29,2696,1453,1243
100266,Tau Group 66,2024-03-22,2024-05-13,2024-07-18,1502,976,526
100267,Tau Group 66,2024-02-10,2024-03-15,2024-06-25,4958,2794,2164
100268,Tau Group 66,2023-12-08,2024-01-02,2024-03-17,1283,938,345
100269,Tau Group 66,2024-06-27,2024-08-13,2024-12-26,2471,1733,738
100270,Tau Group 66,2023-12-26,2024-02-20,2024-06-05,3156,1724,1432
100271,Tau Group 66,2023-04-16,2023-05-10,2023-08-08,4729,3244,1485
100272,Tau Group 66,2024-09-08,2024-10-02,2024-12-06,1276,714,562
100273,Tau Group 66,2023-07-01,2023-08-25,2024-03-02,4395,2753,1642
100274,Tau Group 66,2025-02-17,2025-04-10,2025-10-17,3012,1921,1091
100275,Tau Group 66,2024-10-20,2024-12-14,2025-04-21,1822,917,905
100276,Tau Group 66,2025-06-03,2025-07-28,2026-01-02,3554,2385,1169
100277,Tau Group 66,2023-03-11,2023-04-25,2023-08-26,3238,2071,1167
100278,Tau Group 66,2025-03-26,2025-04-27,2025-09-10,2279,1372,907
100279,Tau Group 66,2024-06-03,2024-06-22,2024-11-30,3083,2073,1010
100280,Tau Group 66,2023-02-08,2023-02-26,2023-06-25,2537,1669,868
100281,Tau Group 66,2023-03-20,2023-05-15,2023-07-23,3136,1674,1462
100282,Tau Group 66,2024-09-21,2024-11-13,2025-04-26,3794,2365,1429
100283,Tau Group 66,2024-08-17,2024-10-06,2024-12-01,4903,2508,2395
100284,Rho Export 173,2025-07-19,2025-09-08,2026-01-14,1514,889,625
100285,Rho Export 173,2024-09-11,2024-10-26,2024-12-26,5559,3472,2087
100286,Rho Export 173,2024-04-06,2024-04-27,2024-09-07,657,360,297
100287,Rho Export 173,2025-01-01,2025-01-21,2025-04-21,2817,1757,1060
100288,Rho Export 173,2023-02-10,2023-03-12,2023-08-17,3705,2123,1582
100289,Rho Export 173,2024-06-20,2024-08-07,2024-12-24,3337,1994,1343
100290,Rho Export 173,2024-01-17,2024-02-19,2024-06-30,2252,1471,781
100291,Rho Export 173,2024-11-26,2025-01-18,2025-05-29,2750,2026,724
100292,Rho Export 173,2023-03-09,2023-04-14,2023-09-05,2408,1749,659
100293,Rho Export 173,2023-10-18,2023-11-18,2024-06-05,2292,1304,988
100294,Rho Export 173,2025-06-13,2025-07-07,2026-01-18,4019,2679,1340
100295,Rho Export 173,2024-11-10,2024-12-04,2025-04-08,3428,1785,1643
100296,Rho Export 173,2024-11-02,2024-12-31,2025-03-20,2168,1267,901
100297,Rho Export 173,2024-09-01,2024-10-31,2025-03-05,4079,2103,1976
100298,Rho Export 173,2024-07-26,2024-09-03,2025-01-11,3368,1984,1384
100299,Rho Export 173,2025-04-12,2025-05-05,2025-11-01,3975,2315,1660
100300,Rho Export 173,2023-04-06,2023-06-01,2023-11-24,3755,2187,1568
100301,Rho Export 173,2024-01-06,2024-01-22,2024-04-23,2005,1322,683
100302,Rho Export 173,2025-08-31,2025-09-28,2026-03-17,2327,1546,781
100303,Rho Export 173,2023-07-16,2023-08-14,2023-11-07,3896,1948,1948
100304,Rho Export 173,2023-03-21,2023-04-23,2023-07-03,3732,2011,1721
100305,Rho Export 173,2024-06-03,2024-07-22,2025-01-18,2974,1610,1364
100306,Rho Export 173,2023-02-08,2023-04-06,2023-06-24,3140,2091,1049
100307,Rho Export 173,2024-09-03,2024-10-12,2025-01-12,4533,3225,1308
100308,Rho Export 173,2025-05-01,2025-06-29,2025-09-25,2290,1276,1014
100309,Rho Export 173,2025-01-08,2025-02-20,2025-07-09,3656,2702,954
100310,Rho Export 173,2024-11-23,2024-12-23,2025-04-20,2757,1399,1358
100311,Rho Export 173,2025-02-09,2025-03-24,2025-07-09,2738,1893,845
100312,Rho Export 173,2023-11-13,2023-12-28,2024-04-01,4318,2263,2055
100313,Rho Export 173,2024-01-12,2024-03-10,2024-08-15,3990,2048,1942
100314,Rho Export 173,2024-04-17,2024-05-20,2024-11-10,3976,2209,1767
100315,Rho Export 173,2024-06-24,2024-08-04,2024-11-09,4566,2322,2244
100316,Psi Services 188,2024-09-11,2024-10-04,2024-11-25,3025,948,2077
100317,Psi Services 188,2024-10-18,2024-12-02,2025-03-28,3818,1195,2623
100318,Psi Services 188,2025-08-14,2025-09-04,2025-12-25,2627,1036,1591
100319,Psi Services 188,2025-05-21,2025-06-12,2025-08-17,3388,2058,1330
100320,Psi Services 188,2023-10-07,2023-11-19,2024-01-22,2843,845,1998
100321,Psi Services 188,2025-04-30,2025-06-11,2025-08-24,3116,2194,922
100322,Psi Services 188,2025-04-16,2025-05-29,2025-07-17,3714,1143,2571
100323,Psi Services 188,2024-02-29,2024-03-18,2024-06-19,2018,1113,905
100324,Psi Services 188,2023-08-30,2023-10-08,2024-01-09,5510,1393,4117
100325,Psi Services 188,2023-08-18,2023-09-03,2023-10-31,1792,1058,734
100326,Psi Services 188,2025-05-09,2025-07-08,2025-09-10,1542,655,887
100327,Psi Services 188,2023-05-21,2023-06-07,2023-09-21,4389,2662,1727
100328,Beta LLC 71,2025-05-01,2025-05-24,2025-09-07,3949,1463,2486
100329,Beta LLC 71,2024-04-04,2024-05-28,2024-07-23,3748,2801,947
100330,Beta LLC 71,2023-01-20,2023-02-20,2023-04-26,3754,2411,1343
100331,Beta LLC 71,2024-07-15,2024-09-06,2024-11-05,2985,1451,1534
100332,Beta LLC 71,2025-03-05,2025-04-07,2025-06-07,1923,1214,709
100333,Beta LLC 71,2023-02-18,2023-03-20,2023-07-02,3090,1669,1421
100334,Beta LLC 71,2023-03-06,2023-03-28,2023-07-15,2187,725,1462
100335,Beta LLC 71,2024-09-03,2024-10-22,2025-02-10,4170,3093,1077
100336,Beta LLC 71,2024-08-11,2024-09-10,2024-12-02,2823,1103,1720
100337,Beta LLC 71,2024-03-15,2024-03-30,2024-06-14,2009,889,1120
100338,Beta LLC 71,2024-08-07,2024-09-17,2024-11-12,2614,1716,898
100339,Sigma LLC 6,2024-01-05,2024-01-24,2024-05-18,3495,955,2540
100340,Sigma LLC 6,2024-06-03,2024-07-20,2024-10-23,2323,1099,1224
100341,Sigma LLC 6,2025-06-13,2025-07-28,2025-10-31,2013,1466,547
100342,Sigma LLC 6,2024-01-18,2024-02-18,2024-05-19,3292,1239,2053
100343,Sigma LLC 6,2025-03-18,2025-04-06,2025-06-04,3293,1902,1391
100344,Sigma LLC 6,2025-03-01,2025-04-22,2025-07-19,2391,914,1477
100345,Sigma LLC 6,2023-05-17,2023-06-03,2023-08-31,2434,1397,1037
100346,Sigma LLC 6,2025-04-13,2025-06-08,2025-09-21,3278,2172,1106
100347,Sigma LLC 6,2024-12-13,2025-01-27,2025-03-31,1262,548,714
100348,Sigma LLC 6,2023-03-06,2023-05-05,2023-08-17,1311,474,837
100349,Sigma SARL 130,2023-10-28,2023-11-24,2024-02-03,2137,1556,581
100350,Sigma SARL 130,2025-06-26,2025-07-13,2025-10-06,2743,1624,1119
100351,Sigma SARL 130,2024-06-11,2024-07-21,2024-11-13,3373,862,2511
100352,Sigma SARL 130,2024-04-29,2024-05-30,2024-08-08,4770,3490,1280
100353,Sigma SARL 130,2023-10-20,2023-11-26,2024-01-17,4029,1285,2744
100354,Sigma SARL 130,2025-06-05,2025-07-31,2025-09-30,2808,1640,1168
100355,Gamma Enterprises 56,2024-01-12,2024-02-23,2024-06-04,2977,909,2068
100356,Gamma Enterprises 56,2025-07-05,2025-08-13,2025-10-21,1796,1043,753
100357,Gamma Enterprises 56,2024-05-23,2024-07-21,2024-11-10,2977,1492,1485
100358,Gamma Enterprises 56,2023-10-01,2023-10-21,2023-12-16,2653,1025,1628
100359,Gamma Enterprises 56,2024-03-16,2024-05-08,2024-07-16,3387,855,2532
100360,Gamma Enterprises 56,2024-07-12,2024-08-14,2024-10-09,2007,1183,824
100361,Gamma Enterprises 56,2023-12-02,2024-01-28,2024-05-10,3623,2182,1441
100362,Gamma Enterprises 56,2024-09-09,2024-11-08,2025-02-18,4839,2598,2241
100363,Gamma Enterprises 56,2023-12-26,2024-02-07,2024-05-08,2869,2091,778
100364,Gamma Enterprises 56,2024-09-21,2024-11-02,2024-12-25,3482,2133,1349
100365,Gamma Enterprises 56,2023-03-18,2023-05-14,2023-08-14,3828,1651,2177
100366,Gamma Enterprises 56,2024-06-09,2024-08-06,2024-09-24,2518,1687,831
100367,Upsilon Services 96,2025-05-19,2025-07-11,2025-10-21,3268,1343,1925
100368,Upsilon Services 96,2023-02-05,2023-02-28,2023-05-31,3015,2160,855
100369,Upsilon Services 96,2024-01-06,2024-02-14,2024-04-04,3117,858,2259
100370,Upsilon Services 96,2024-09-11,2024-10-05,2025-01-06,2072,850,1222
100371,Upsilon Services 96,2024-01-16,2024-02-28,2024-06-26,3029,1116,1913
100372,Upsilon Services 96,2023-05-21,2023-07-08,2023-10-02,3597,2038,1559
100373,Upsilon Services 96,2024-10-27,2024-11-28,2025-01-27,4741,2964,1777
100374,Epsilon Services 199,2025-01-23,2025-02-18,2025-05-24,4151,2077,2074
100375,Epsilon Services 199,2025-07-24,2025-09-12,2025-11-30,5583,3859,1724
100376,Epsilon Services 199,2024-12-21,2025-02-02,2025-04-25,2079,1336,743
100377,Epsilon Services 199,2024-12-11,2025-01-26,2025-03-30,4046,2630,1416
100378,Epsilon Services 199,2025-05-23,2025-06-11,2025-09-21,3220,1687,1533
100379,Epsilon Services 199,2023-03-31,2023-05-28,2023-08-22,5627,1498,4129
100380,Chi Group 136,2023-12-22,2024-02-20,2024-06-14,2030,1457,573
100381,Chi Group 136,2023-10-25,2023-11-28,2024-02-04,1992,646,1346
100382,Chi Group 136,2025-03-23,2025-04-30,2025-06-30,2280,1130,1150
100383,Chi Group 136,2023-07-25,2023-08-17,2023-12-04,451,285,166
100384,Chi Group 136,2023-01-27,2023-03-06,2023-06-07,2369,1121,1248
100385,Chi Group 136,2024-04-23,2024-06-12,2024-08-08,2089,1431,658
100386,Chi Group 136,2023-03-09,2023-04-12,2023-07-28,3180,1752,1428
100387,Chi Group 136,2024-06-22,2024-08-02,2024-11-29,3410,1246,2164
100388,Chi Group 136,2023-03-17,2023-04-09,2023-06-03,5251,1385,3866
100389,Chi Group 136,2024-04-05,2024-05-19,2024-08-17,4140,1697,2443
100390,Chi Group 136,2023-05-12,2023-07-01,2023-09-08,2307,992,1315
100391,Delta Enterprises 144,2023-05-13,2023-06-24,2023-08-16,1921,958,963
100392,Delta Enterprises 144,2025-05-01,2025-05-23,2025-08-15,3590,1763,1827
100393,Delta Enterprises 144,2023-06-18,2023-07-13,2023-09-25,1415,833,582
100394,Delta Enterprises 144,2023-12-21,2024-02-07,2024-04-03,5197,1572,3625
100395,Delta Enterprises 144,2023-09-14,2023-10-11,2024-02-04,4415,1909,2506
100396,Delta Enterprises 144,2023-10-09,2023-11-01,2024-02-23,2436,1066,1370
100397,Delta Enterprises 144,2023-04-06,2023-05-23,2023-09-20,944,405,539
100398,Delta Enterprises 144,2023-06-07,2023-07-02,2023-09-29,4624,1945,2679
100399,Delta Enterprises 144,2025-05-12,2025-07-02,2025-08-20,2862,2088,774
100400,Delta Enterprises 144,2023-03-25,2023-04-11,2023-08-08,4485,1237,3248
100401,Delta Enterprises 144,2023-09-29,2023-11-24,2024-03-22,1086,700,386
100402,Delta Enterprises 144,2024-03-02,2024-04-25,2024-08-12,2280,982,1298
100403,Zeta Group 155,2024-07-12,2024-08-14,2024-11-06,3006,1290,1716
100404,Zeta Group 155,2024-05-09,2024-06-08,2024-09-13,3056,1062,1994
100405,Zeta Group 155,2023-11-01,2023-12-15,2024-02-06,2459,1755,704
100406,Zeta Group 155,2023-06-11,2023-07-24,2023-11-06,3747,2032,1715
100407,Zeta Group 155,2023-07-28,2023-09-02,2023-11-27,1718,767,951
100408,Zeta Group 155,2025-06-01,2025-07-31,2025-10-29,2829,1670,1159
100409,Zeta Group 155,2024-02-13,2024-03-07,2024-06-26,3144,1162,1982
100410,Zeta Group 155,2024-07-29,2024-08-19,2024-12-02,3617,2136,1481
100411,Zeta Group 155,2023-05-06,2023-06-07,2023-08-10,3853,2024,1829
100412,Zeta Group 155,2023-04-10,2023-04-28,2023-08-01,1650,998,652
100413,Zeta Group 155,2025-06-03,2025-07-27,2025-10-01,1159,627,532
100414,Sigma Import 146,2023-12-02,2024-01-22,2024-04-01,4533,1765,2768
100415,Sigma Import 146,2025-02-20,2025-03-17,2025-07-06,3398,1702,1696
100416,Sigma Import 146,2024-04-23,2024-06-08,2024-09-25,2101,652,1449
100417,Sigma Import 146,2023-01-24,2023-02-13,2023-06-03,4861,1348,3513
100418,Sigma Import 146,2024-04-13,2024-05-13,2024-08-12,3138,2016,1122
100419,Sigma Import 146,2023-02-19,2023-03-09,2023-06-23,4415,2690,1725
100420,Sigma Import 146,2023-10-20,2023-12-08,2024-02-05,3081,2298,783
100421,Sigma Import 146,2024-03-17,2024-04-09,2024-07-10,5472,1690,3782
100422,Sigma Import 146,2025-02-21,2025-04-02,2025-07-08,5106,2895,2211
100423,Sigma Import 146,2023-02-22,2023-04-14,2023-07-15,2701,1267,1434
100424,Sigma Import 146,2024-07-20,2024-08-22,2024-12-10,4165,2971,1194
100425,Sigma Import 146,2024-04-06,2024-05-26,2024-07-26,3774,2303,1471
100426,Chi Co 5,2023-04-10,2023-05-20,2023-08-17,4642,2615,2027
100427,Chi Co 5,2024-07-25,2024-09-01,2024-11-11,1842,686,1156
100428,Chi Co 5,2024-09-08,2024-10-25,2024-12-15,3823,2100,1723
100429,Chi Co 5,2023-02-16,2023-03-05,2023-06-01,4270,2910,1360
100430,Chi Co 5,2025-04-03,2025-05-18,2025-07-22,889,436,453
100431,Chi Co 5,2024-09-12,2024-10-29,2025-01-23,1580,1075,505
100432,Chi Co 5,2023-06-16,2023-07-26,2023-10-18,552,141,411
100433,Tau LLC 101,2023-12-11,2024-01-27,2024-05-20,2676,899,1777
100434,Tau LLC 101,2024-05-16,2024-07-15,2024-10-29,3861,1809,2052
100435,Tau LLC 101,2025-04-15,2025-05-01,2025-06-30,4802,2717,2085
100436,Tau LLC 101,2024-03-02,2024-04-23,2024-06-11,3088,1841,1247
100437,Tau LLC 101,2024-09-03,2024-10-18,2025-02-15,4954,3058,1896
100438,Tau LLC 101,2024-08-14,2024-09-12,2025-01-10,1343,523,820
100439,Tau LLC 101,2024-05-06,2024-05-31,2024-09-02,955,466,489
100440,Tau LLC 101,2023-06-01,2023-07-29,2023-11-25,2933,1845,1088
100441,Tau LLC 101,2025-08-28,2025-10-26,2025-12-13,3460,2405,1055
100442,Tau LLC 101,2024-03-27,2024-05-01,2024-08-07,2960,1600,1360
100443,Kappa Industries 30,2023-07-28,2023-09-07,2023-12-22,519,259,260
100444,Kappa Industries 30,2025-06-12,2025-06-30,2025-10-20,2893,1149,1744
100445,Kappa Industries 30,2023-08-01,2023-09-20,2024-01-05,1434,842,592
100446,Kappa Industries 30,2024-06-22,2024-07-31,2024-10-07,3803,2256,1547
100447,Kappa Industries 30,2024-04-15,2024-06-03,2024-09-02,3439,1991,1448
100448,Kappa Industries 30,2024-11-23,2025-01-20,2025-04-09,1872,802,1070
100449,Kappa Industries 30,2024-09-16,2024-10-31,2025-01-16,2383,1558,825
100450,Kappa Industries 30,2023-10-13,2023-12-02,2024-02-24,1728,1038,690
100451,Kappa Industries 30,2025-02-28,2025-04-02,2025-07-19,2924,1162,1762
100452,Kappa Industries 30,2023-11-21,2024-01-05,2024-03-26,4146,2386,1760
100453,Kappa Industries 30,2023-10-22,2023-11-13,2024-03-07,1817,842,975
100454,Beta Services 54,2025-07-06,2025-08-15,2025-10-18,3604,1228,2376
100455,Beta Services 54,2023-10-25,2023-11-11,2024-01-06,2363,1432,931
100456,Beta Services 54,2023-12-21,2024-02-02,2024-05-19,2048,864,1184
100457,Beta Services 54,2023-08-08,2023-09-04,2023-11-23,2871,965,1906
100458,Beta Services 54,2025-08-13,2025-10-02,2025-12-04,1757,706,1051
100459,Beta Services 54,2023-04-22,2023-06-15,2023-08-30,2335,886,1449
100460,Beta Services 54,2023-09-06,2023-09-24,2024-01-15,1562,648,914
100461,Beta Services 54,2023-08-20,2023-10-14,2023-12-11,5357,3394,1963
100462,Beta Services 54,2024-02-28,2024-04-04,2024-06-01,3042,1190,1852
100463,Rho LLC 175,2025-02-28,2025-03-23,2025-04-28,2160,1938,222
100464,Rho LLC 175,2025-08-09,2025-09-03,2025-10-04,3256,2268,988
100465,Rho LLC 175,2024-05-03,2024-06-28,2024-07-17,2865,2293,572
100466,Rho LLC 175,2023-11-25,2023-12-28,2024-01-03,2734,1578,1156
100467,Rho LLC 175,2024-10-29,2024-12-19,2024-12-22,3737,2929,808
100468,Rho LLC 175,2025-07-24,2025-08-19,2025-08-31,3909,2701,1208
100469,Rho LLC 175,2025-08-14,2025-08-31,2025-09-26,2363,949,1414
100470,Rho LLC 175,2025-03-17,2025-05-02,2025-05-21,2309,1863,446
100471,Beta Group 142,2023-01-10,2023-02-13,2023-02-20,2669,1644,1025
100472,Beta Group 142,2025-08-08,2025-09-13,2025-10-25,237,180,57
100473,Beta Group 142,2024-07-10,2024-08-27,2024-09-05,1181,771,410
100474,Pi SARL 165,2024-04-24,2024-05-26,2024-06-03,4640,3729,911
100475,Pi SARL 165,2023-12-05,2023-12-30,2024-02-10,4973,2658,2315
100476,Pi SARL 165,2023-09-21,2023-11-20,2023-12-12,2701,2179,522
100477,Pi SARL 165,2025-03-20,2025-04-22,2025-05-05,3691,2274,1417
100478,Pi SARL 165,2023-06-29,2023-08-22,2023-09-17,3373,1592,1781
100479,Pi SARL 165,2025-04-26,2025-06-07,2025-06-13,6694,4300,2394
100480,Pi SARL 165,2024-02-15,2024-04-12,2024-04-21,4343,3702,641
100481,Psi Enterprises 111,2023-11-28,2023-12-28,2024-01-22,2846,2552,294
100482,Psi Enterprises 111,2023-08-30,2023-10-12,2023-11-03,1853,969,884
100483,Psi Enterprises 111,2023-11-06,2023-12-28,2023-12-29,1072,577,495
100484,Psi Enterprises 111,2023-09-25,2023-11-20,2023-12-06,3244,2336,908
100485,Psi Enterprises 111,2023-03-05,2023-05-01,2023-05-21,2092,1759,333
100486,Psi Enterprises 111,2023-06-13,2023-07-23,2023-08-12,1293,720,573
100487,Zeta Co 18,2023-05-01,2023-06-25,2023-07-14,2224,983,1241
100488,Zeta Co 18,2024-01-12,2024-03-06,2024-03-15,1702,1344,358
100489,Zeta Co 18,2024-05-04,2024-05-28,2024-07-06,5024,3379,1645
100490,Zeta Co 18,2024-01-18,2024-02-28,2024-03-30,4057,2227,1830
100491,Zeta Co 18,2025-02-14,2025-04-04,2025-04-18,2990,1492,1498
100492,Zeta Co 18,2025-02-19,2025-03-21,2025-04-29,4775,2673,2102
100493,Zeta Co 18,2025-06-13,2025-07-03,2025-08-06,3092,1970,1122
100494,Zeta Co 18,2024-12-21,2025-01-28,2025-03-06,1966,1693,273
100495,Pi Trading 97,2023-03-05,2023-04-24,2023-05-07,4827,2165,2662
100496,Pi Trading 97,2024-08-09,2024-09-27,2024-10-18,3646,3008,638
100497,Pi Trading 97,2025-05-24,2025-07-11,2025-08-24,1755,1192,563
100498,Kappa Enterprises 99,2025-01-04,2025-02-25,2025-03-30,2771,1817,954
100499,Kappa Enterprises 99,2024-04-01,2024-04-19,2024-05-22,1949,1312,637
100500,Kappa Enterprises 99,2024-03-01,2024-04-14,2024-05-20,1340,828,512
100501,Kappa Enterprises 99,2024-04-18,2024-06-15,2024-06-17,4111,2041,2070
100502,Omega Tech 131,2023-09-18,2023-10-03,2023-11-10,5291,2789,2502
100503,Omega Tech 131,2023-03-16,2023-04-02,2023-05-17,1321,909,412
100504,Omega Tech 131,2023-03-07,2023-04-25,2023-04-30,3675,1481,2194
100505,Omega Tech 131,2025-08-14,2025-09-28,2025-10-25,2219,1962,257
100506,Omega Tech 131,2023-07-04,2023-07-27,2023-09-07,2415,1249,1166
100507,Omega Tech 131,2024-03-06,2024-04-13,2024-05-08,2289,924,1365
100508,Alpha Industries 79,2025-06-09,2025-07-18,2025-08-31,1963,1398,565
100509,Alpha Industries 79,2024-11-08,2024-12-27,2025-01-19,3058,2549,509
100510,Alpha Industries 79,2023-05-02,2023-05-28,2023-06-23,2002,808,1194
100511,Alpha Industries 79,2024-06-25,2024-07-18,2024-08-02,3324,1782,1542
100512,Alpha Industries 79,2025-05-04,2025-05-19,2025-06-08,2939,1534,1405
100513,Alpha Industries 79,2024-04-19,2024-06-16,2024-07-14,2713,1466,1247
100514,Eta Enterprises 145,2024-01-24,2024-02-22,2024-03-16,1910,1483,427
100515,Eta Enterprises 145,2023-06-08,2023-07-10,2023-07-18,2307,1859,448
100516,Eta Enterprises 145,2023-02-02,2023-03-31,2023-04-02,3906,2697,1209
100517,Eta Enterprises 145,2023-09-04,2023-10-02,2023-11-10,3601,3120,481
100518,Eta Enterprises 145,2023-02-04,2023-03-19,2023-03-23,1826,1098,728
100519,Eta Enterprises 145,2023-09-08,2023-09-25,2023-10-10,3119,2180,939
100520,Eta Enterprises 145,2024-07-06,2024-08-03,2024-08-07,3901,2039,1862
100521,Epsilon Group 147,2024-05-30,2024-07-02,2024-08-08,996,780,216
100522,Epsilon Group 147,2023-11-23,2024-01-13,2024-02-26,3652,2195,1457
100523,Epsilon Group 147,2025-04-18,2025-05-23,2025-06-02,2204,1723,481
100524,Epsilon Group 147,2024-11-07,2024-12-25,2025-01-14,3684,2908,776
100525,Tau Group 7,2023-03-04,2023-04-23,2023-05-05,2084,887,1197
100526,Tau Group 7,2024-10-03,2024-11-30,2025-01-01,834,572,262
100527,Tau Group 7,2023-02-18,2023-03-27,2023-05-09,1046,449,597
100528,Tau Group 7,2024-01-26,2024-03-14,2024-04-10,3057,2264,793
100529,Tau Group 7,2024-02-23,2024-03-18,2024-03-30,3311,2483,828
100530,Epsilon Industries 105,2024-04-29,2024-05-29,2024-06-18,1914,910,1004
100531,Epsilon Industries 105,2025-05-28,2025-07-27,2025-08-26,3766,3118,648
100532,Epsilon Industries 105,2025-07-25,2025-08-12,2025-09-08,1006,623,383
100533,Epsilon Industries 105,2024-07-24,2024-09-10,2024-09-26,2920,2432,488
100534,Epsilon Industries 105,2023-09-19,2023-10-17,2023-10-23,1546,1136,410
100535,Epsilon Industries 105,2025-08-02,2025-09-14,2025-09-20,2217,1056,1161
100536,Epsilon Industries 105,2024-07-02,2024-07-29,2024-08-23,3056,2672,384
100537,Sigma LLC 151,2024-09-11,2024-11-03,2024-11-08,1967,1731,236
100538,Sigma LLC 151,2023-07-12,2023-09-02,2023-10-08,2538,1365,1173
100539,Sigma LLC 151,2023-08-11,2023-09-25,2023-10-17,4207,3347,860
100540,Sigma LLC 151,2023-11-07,2023-11-22,2023-12-05,2307,1832,475
100541,Sigma LLC 151,2025-01-29,2025-02-20,2025-03-23,4002,2107,1895
100542,Sigma LLC 151,2025-07-25,2025-08-24,2025-09-07,1644,908,736
100543,Sigma LLC 151,2024-02-11,2024-03-12,2024-03-31,3635,2268,1367
100544,Sigma LLC 151,2024-01-25,2024-03-09,2024-04-01,4729,2994,1735
100545,Eta Services 21,2023-09-25,2023-11-02,2023-12-04,50,32,18
100546,Eta Services 21,2024-04-22,2024-05-13,2024-06-13,2043,1019,1024
100547,Eta Services 21,2025-02-18,2025-03-25,2025-04-18,3692,1635,2057
100548,Eta Services 21,2023-11-17,2023-12-28,2024-01-12,2756,2417,339
100549,Eta Services 21,2025-01-29,2025-02-22,2025-03-30,3445,3073,372
100550,Phi Co 50,2024-08-16,2024-09-26,2024-10-09,2275,1712,563
100551,Phi Co 50,2023-12-04,2024-01-02,2024-01-18,3103,2203,900
100552,Phi Co 50,2024-05-26,2024-07-15,2024-08-28,2813,1611,1202
100553,Phi Co 50,2023-12-12,2024-01-12,2024-02-13,4401,2281,2120
100554,Phi Co 50,2025-01-10,2025-03-07,2025-04-06,3305,1752,1553
100555,Phi Co 50,2023-06-22,2023-07-29,2023-09-02,3405,2776,629
100556,Phi Co 50,2024-05-15,2024-06-10,2024-07-15,2505,1106,1399
100557,Zeta Trading 174,2023-03-02,2023-04-19,2023-04-24,2414,2132,282
100558,Zeta Trading 174,2025-08-25,2025-10-21,2025-10-22,2480,2172,308
100559,Zeta Trading 174,2024-02-27,2024-03-21,2024-04-05,3473,1663,1810
100560,Zeta Trading 174,2023-03-11,2023-05-10,2023-05-24,2494,2056,438
100561,Zeta Trading 174,2024-06-01,2024-07-15,2024-08-24,3347,2388,959
100562,Zeta Trading 174,2024-10-15,2024-12-11,2025-01-11,5490,2377,3113
100563,Zeta Trading 174,2024-11-06,2024-12-22,2025-01-26,4045,3609,436
100564,Zeta Trading 174,2024-07-18,2024-08-28,2024-10-01,2608,2332,276
100565,Phi Import 59,2023-10-09,2023-11-27,2023-11-29,4441,1826,2615
100566,Phi Import 59,2024-05-29,2024-07-27,2024-08-08,2510,1413,1097
100567,Phi Import 59,2023-04-20,2023-05-11,2023-05-27,554,353,201
100568,Phi Import 59,2023-07-16,2023-09-08,2023-10-01,1790,1140,650
100569,Phi Import 59,2023-10-01,2023-11-10,2023-12-06,755,650,105
100570,Phi Import 59,2024-04-15,2024-06-05,2024-07-20,2578,2007,571
100571,Phi Import 59,2023-08-20,2023-09-23,2023-09-29,3022,1686,1336
100572,Phi Import 59,2024-10-31,2024-12-26,2025-01-01,5011,2607,2404
100573,Omega Export 163,2024-01-24,2024-03-03,2024-03-07,3392,2115,1277
100574,Omega Export 163,2024-10-14,2024-10-29,2024-11-04,2737,1501,1236
100575,Omega Export 163,2024-05-26,2024-07-07,2024-07-29,3995,2307,1688
100576,Omega Export 163,2024-08-02,2024-08-23,2024-08-26,346,157,189
100577,Omega Export 163,2023-08-24,2023-09-21,2023-11-05,3282,1475,1807
100578,Omega Export 163,2025-06-27,2025-08-17,2025-08-20,3925,2599,1326
100579,Sigma Enterprises 12,2024-12-01,2025-01-02,2025-02-08,1225,552,673
100580,Sigma Enterprises 12,2024-11-04,2024-11-21,2024-12-12,4372,3543,829
100581,Sigma Enterprises 12,2023-01-17,2023-02-14,2023-03-12,3406,2066,1340
100582,Mu Group 137,2023-11-03,2023-11-28,2024-01-04,2501,1546,955
100583,Mu Group 137,2025-05-04,2025-06-12,2025-07-17,3759,2111,1648
100584,Mu Group 137,2023-12-06,2024-01-14,2024-01-23,5724,2989,2735
100585,Sigma Trading 153,2025-01-11,2025-01-31,2025-02-23,3218,2090,1128
100586,Sigma Trading 153,2023-02-24,2023-03-17,2023-03-22,3297,2247,1050
100587,Sigma Trading 153,2023-12-15,2024-02-06,2024-03-16,2448,1262,1186
100588,Sigma Trading 153,2024-02-11,2024-03-17,2024-04-04,1980,1753,227
100589,Sigma Trading 153,2025-03-13,2025-04-25,2025-05-18,3996,2616,1380
100590,Sigma Trading 153,2024-07-20,2024-08-28,2024-10-11,1972,1349,623
100591,Sigma Trading 153,2024-08-22,2024-10-18,2024-11-27,3085,2190,895
100592,Sigma Trading 153,2023-10-30,2023-11-29,2023-12-05,2426,1318,1108
100593,Omega Enterprises 47,2023-06-07,2023-07-16,2023-08-26,3574,1945,1629
100594,Omega Enterprises 47,2023-06-07,2023-07-16,2023-07-23,3400,2522,878
100595,Omega Enterprises 47,2023-04-04,2023-04-19,2023-05-18,4245,1819,2426
100596,Omega Enterprises 47,2024-01-04,2024-02-05,2024-02-11,2387,2026,361
100597,Omega Enterprises 47,2023-07-11,2023-08-22,2023-09-27,2676,1808,868
100598,Zeta Export 46,2024-02-22,2024-03-14,2024-04-06,1825,1619,206
100599,Zeta Export 46,2024-07-21,2024-08-10,2024-08-31,2466,1483,983
100600,Zeta Export 46,2025-06-03,2025-07-12,2025-08-08,3452,3086,366
100601,Zeta Export 46,2024-02-02,2024-02-22,2024-03-29,3908,2101,1807
100602,Zeta Export 46,2025-07-15,2025-08-14,2025-08-25,1893,1162,731
100603,Zeta Export 46,2024-12-02,2025-01-10,2025-01-28,4043,3296,747
100604,Zeta Export 46,2023-11-05,2023-12-07,2023-12-12,4626,3023,1603
100605,Psi Industries 43,2024-03-21,2024-04-22,2024-05-23,3496,2410,1086
100606,Psi Industries 43,2025-03-12,2025-03-31,2025-04-16,5252,3778,1474
100607,Psi Industries 43,2025-01-08,2025-03-04,2025-04-13,2071,1350,721
100608,Psi Industries 43,2023-07-20,2023-09-02,2023-09-22,1506,1275,231
100609,Pi Export 106,2025-08-29,2025-10-08,2025-11-17,865,635,230
100610,Pi Export 106,2024-01-25,2024-03-01,2024-03-29,4795,3260,1535
100611,Pi Export 106,2025-04-15,2025-06-10,2025-06-19,3785,1563,2222
100612,Omega LLC 80,2023-11-25,2024-01-17,2024-01-30,2933,1251,1682
100613,Omega LLC 80,2024-05-05,2024-06-09,2024-07-05,3335,2705,630
100614,Omega LLC 80,2023-11-23,2023-12-26,2024-02-05,1649,878,771
100615,Omega LLC 80,2024-05-17,2024-07-07,2024-07-28,5934,3020,2914
100616,Omega LLC 80,2024-01-21,2024-02-22,2024-03-19,3155,1551,1604
100617,Zeta Industries 73,2023-04-27,2023-06-17,2023-07-22,3131,2505,626
100618,Zeta Industries 73,2023-07-04,2023-08-31,2023-09-02,3870,1998,1872
100619,Zeta Industries 73,2025-01-14,2025-02-27,2025-03-13,3577,1533,2044
100620,Zeta Industries 73,2024-03-24,2024-04-26,2024-05-01,3268,1583,1685
100621,Zeta Industries 73,2025-04-18,2025-05-29,2025-06-07,2051,1156,895
100622,Beta SARL 158,2023-11-07,2023-12-07,2023-12-17,3565,2758,807
100623,Beta SARL 158,2025-01-02,2025-02-13,2025-02-18,5258,2658,2600
100624,Beta SARL 158,2024-04-04,2024-05-27,2024-06-22,4614,3047,1567
100625,Beta SARL 158,2024-07-01,2024-08-17,2024-10-01,4911,2152,2759
100626,Beta SARL 158,2024-03-04,2024-04-22,2024-05-16,2386,2104,282
100627,Beta SARL 158,2024-12-19,2025-02-06,2025-02-12,1812,1093,719
100628,Beta SARL 158,2023-04-22,2023-05-22,2023-06-14,2849,1627,1222
100629,Beta SARL 158,2023-06-20,2023-08-15,2023-09-21,3066,1820,1246
100630,Chi Enterprises 178,2024-11-24,2025-01-19,2025-02-10,4313,3020,1293
100631,Chi Enterprises 178,2025-03-26,2025-05-07,2025-05-14,969,821,148
100632,Chi Enterprises 178,2023-09-22,2023-10-21,2023-11-24,4835,3117,1718
100633,Chi Enterprises 178,2024-07-25,2024-09-15,2024-09-30,2810,1563,1247
100634,Chi Enterprises 178,2024-04-01,2024-05-09,2024-06-22,2487,1752,735
100635,Chi Enterprises 178,2024-08-25,2024-10-23,2024-11-15,1785,1160,625
100636,Chi Enterprises 178,2023-01-26,2023-03-12,2023-04-08,1014,860,154
100637,Chi Enterprises 178,2025-07-31,2025-08-20,2025-08-30,3987,3357,630
100638,Upsilon Industries 45,2023-11-16,2023-12-22,2024-01-05,3087,2075,1012
100639,Upsilon Industries 45,2024-06-17,2024-08-01,2024-08-08,1452,1054,398
100640,Upsilon Industries 45,2024-03-24,2024-05-22,2024-05-27,1445,974,471
100641,Upsilon Industries 45,2023-11-04,2023-11-21,2023-11-29,2597,1285,1312
100642,Upsilon Industries 45,2023-01-24,2023-03-01,2023-04-14,5002,2881,2121
100643,Omicron Enterprises 149,2025-08-10,2025-09-09,2025-10-15,2688,1726,962
100644,Omicron Enterprises 149,2023-06-13,2023-07-19,2023-08-18,1196,742,454
100645,Omicron Enterprises 149,2023-08-26,2023-10-05,2023-10-17,2705,1583,1122
100646,Omicron Enterprises 149,2024-10-17,2024-12-13,2024-12-15,2672,1827,845
100647,Omicron Tech 16,2024-09-20,2024-10-17,2024-11-14,50,34,16
100648,Omicron Tech 16,2024-02-03,2024-02-18,2024-03-03,2934,1607,1327
100649,Omicron Tech 16,2023-10-13,2023-12-12,2023-12-17,2722,1349,1373
100650,Omicron Tech 16,2024-08-14,2024-09-04,2024-10-09,3835,1918,1917
100651,Omicron Tech 16,2023-07-11,2023-08-18,2023-09-17,5218,3846,1372
100652,Omicron Tech 16,2023-04-27,2023-05-28,2023-06-29,4351,2457,1894
100653,Omicron Tech 16,2024-06-24,2024-08-18,2024-09-12,2677,1990,687
100654,Omicron Tech 16,2024-09-17,2024-10-27,2024-11-19,1672,1014,658
100655,Omicron Solutions 161,2025-05-15,2025-06-28,2025-08-11,6088,3600,2488
100656,Omicron Solutions 161,2024-12-23,2025-01-26,2025-03-05,3071,1353,1718
100657,Omicron Solutions 161,2023-03-28,2023-05-25,2023-06-02,3016,2512,504
100658,Omicron Solutions 161,2023-09-02,2023-10-06,2023-10-30,2971,2500,471
100659,Omicron Solutions 161,2024-12-11,2025-01-04,2025-01-31,3237,2087,1150
100660,Nu Solutions 49,2023-05-22,2023-07-12,2023-07-24,2826,2001,825
100661,Nu Solutions 49,2024-05-13,2024-07-07,2024-08-18,2311,1459,852
100662,Nu Solutions 49,2025-08-11,2025-09-06,2025-10-08,2343,1459,884
100663,Nu Solutions 49,2023-10-23,2023-11-15,2023-12-14,2960,2387,573
100664,Nu Solutions 49,2024-09-26,2024-10-14,2024-10-15,2347,1097,1250
100665,Nu Solutions 49,2024-05-11,2024-06-03,2024-06-28,2144,1720,424
100666,Nu Solutions 49,2024-07-29,2024-09-14,2024-10-11,3127,1793,1334
100667,Chi Tech 184,2024-05-18,2024-06-28,2024-07-27,2694,1468,1226
100668,Chi Tech 184,2024-05-15,2024-06-09,2024-06-11,4804,4125,679
100669,Chi Tech 184,2025-03-25,2025-04-23,2025-05-11,50,38,12
100670,Chi Tech 184,2023-08-19,2023-10-07,2023-11-06,4309,3256,1053
100671,Chi Tech 184,2024-08-02,2024-09-17,2024-09-25,4495,2810,1685
100672,Chi Tech 184,2024-08-09,2024-08-31,2024-10-05,511,391,120
100673,Chi Tech 184,2025-04-23,2025-05-31,2025-06-03,2588,1628,960
100674,Chi Tech 184,2025-02-17,2025-04-01,2025-04-29,2554,1601,953
100675,Chi Export 81,2025-01-23,2025-03-20,2025-04-09,1310,687,623
100676,Chi Export 81,2025-06-14,2025-07-01,2025-07-24,2066,1395,671
100677,Chi Export 81,2025-06-01,2025-06-21,2025-06-29,1667,1134,533
100678,Nu Solutions 160,2023-08-03,2023-09-24,2023-11-03,5102,2834,2268
100679,Nu Solutions 160,2024-10-09,2024-11-20,2024-11-29,4122,3368,754
100680,Nu Solutions 160,2025-03-14,2025-04-11,2025-04-15,4525,2232,2293
100681,Nu Solutions 160,2024-08-06,2024-09-12,2024-10-21,3866,2451,1415
100682,Upsilon Tech 195,2023-06-22,2023-07-27,2023-08-15,1645,675,970
100683,Upsilon Tech 195,2023-10-24,2023-12-14,2024-01-16,2370,1816,554
100684,Upsilon Tech 195,2025-07-10,2025-09-06,2025-09-15,3587,1766,1821
100685,Upsilon Tech 195,2025-02-07,2025-03-20,2025-04-07,1533,675,858
100686,Upsilon Tech 195,2025-06-06,2025-08-01,2025-08-10,3855,3225,630
100687,Upsilon Tech 195,2023-09-13,2023-10-07,2023-10-23,2711,1476,1235
100688,Upsilon Tech 195,2025-02-18,2025-04-17,2025-04-27,2550,1794,756
100689,Lambda LLC 83,2024-10-09,2024-11-10,2024-12-05,3853,2258,1595
100690,Lambda LLC 83,2024-04-07,2024-04-26,2024-05-02,3533,2060,1473
100691,Lambda LLC 83,2024-02-17,2024-04-04,2024-05-19,2566,1347,1219
100692,Lambda LLC 83,2025-08-16,2025-09-23,2025-10-25,4391,2954,1437
100693,Lambda LLC 83,2023-12-02,2024-01-23,2024-01-29,1702,1530,172
100694,Lambda LLC 83,2025-01-18,2025-03-03,2025-04-17,3739,2178,1561
100695,Lambda LLC 83,2024-01-02,2024-01-21,2024-02-16,3711,1864,1847
100696,Nu Solutions 55,2024-03-15,2024-04-12,2024-04-10,2628,2301,327
100697,Nu Solutions 55,2023-12-12,2024-01-31,2024-01-27,3391,2957,434
100698,Sigma Enterprises 120,2025-07-04,2025-08-31,2025-08-31,1498,1476,22
100699,Sigma Enterprises 120,2025-03-13,2025-04-26,2025-04-25,4108,3836,272
100700,Sigma Enterprises 120,2023-01-01,2023-02-12,2023-02-07,2778,2399,379
100701,Theta Solutions 189,2023-11-06,2023-12-01,2023-11-29,2372,2339,33
100702,Theta Solutions 189,2024-01-05,2024-02-05,2024-01-31,4258,3681,577
100703,Theta Solutions 189,2023-06-19,2023-07-07,2023-07-05,2154,1919,235
100704,Theta Solutions 189,2025-02-12,2025-03-13,2025-03-13,1309,1171,138
100705,Theta Solutions 189,2023-01-02,2023-01-30,2023-01-29,1132,1031,101
100706,Theta Solutions 189,2024-06-15,2024-08-12,2024-08-12,3727,3338,389
100707,Gamma Group 75,2025-05-30,2025-07-11,2025-07-08,1463,1447,16
100708,Theta Enterprises 117,2023-04-02,2023-04-23,2023-04-21,5105,4430,675
100709,Theta Enterprises 117,2023-05-21,2023-06-29,2023-06-28,501,453,48
100710,Theta Enterprises 117,2024-11-24,2024-12-18,2024-12-14,5035,5029,6
100711,Theta Enterprises 117,2024-10-27,2024-11-21,2024-11-16,3253,3149,104
100712,Nu SARL 190,2023-06-05,2023-07-16,2023-07-13,2883,2511,372
100713,Nu SARL 190,2023-03-30,2023-04-20,2023-04-20,2346,2139,207
100714,Nu SARL 190,2024-01-29,2024-03-06,2024-03-17,3478,3065,413
100715,Nu SARL 190,2023-09-11,2023-10-13,2023-10-12,2954,2709,245
100716,Nu SARL 190,2024-09-06,2024-10-29,2024-10-24,4323,4306,17
100717,Nu SARL 190,2025-05-17,2025-07-13,2025-07-12,3137,2893,244
100718,Psi Export 14,2023-07-13,2023-08-22,2023-08-22,3180,2806,374
100719,Psi Export 14,2025-03-23,2025-04-22,2025-04-22,2563,2470,93
100720,Psi Export 14,2024-10-15,2024-12-07,2024-12-07,2931,2497,434
100721,Psi Export 14,2025-08-14,2025-09-18,2025-09-14,3369,3156,213
100722,Psi Export 14,2024-07-13,2024-09-09,2024-09-06,947,811,136
100723,Xi Enterprises 134,2023-01-18,2023-03-11,2023-03-09,1382,1337,45
100724,Beta Trading 171,2025-08-29,2025-10-08,2025-10-03,3891,3475,416
100725,Mu Enterprises 68,2024-03-09,2024-05-07,2024-05-02,3205,2947,258
100726,Mu Enterprises 68,2024-09-22,2024-10-16,2024-10-14,2779,2746,33
100727,Mu Enterprises 68,2025-08-01,2025-08-29,2025-09-03,3022,2779,243
100728,Mu Enterprises 68,2024-02-05,2024-03-28,2024-03-23,3417,3068,349
100729,Rho SARL 88,2023-11-14,2024-01-12,2024-01-11,2352,2332,20
100730,Iota Co 65,2025-08-04,2025-09-15,2025-09-11,2066,1877,189
100731,Iota Industries 82,2024-11-13,2025-01-09,2025-01-09,3235,3229,6
100732,Iota Industries 82,2023-05-21,2023-07-19,2023-07-16,1825,1564,261
100733,Iota Industries 82,2024-06-19,2024-08-06,2024-08-01,3489,3353,136
100734,Rho Trading 95,2023-05-10,2023-06-11,2023-06-11,956,845,111
100735,Rho Trading 95,2023-01-31,2023-03-08,2023-03-06,4234,3901,333
100736,Rho Trading 95,2023-09-27,2023-11-26,2023-12-17,3567,3526,41
100737,Alpha Co 86,2024-06-07,2024-07-15,2024-07-11,3307,3224,83
100738,Alpha Co 86,2023-06-11,2023-07-12,2023-07-08,4179,3756,423
100739,Alpha Co 86,2023-04-29,2023-05-28,2023-05-28,4998,4965,33
100740,Alpha Co 86,2025-06-02,2025-06-17,2025-06-14,4217,3987,230
100741,Beta Trading 8,2023-07-03,2023-07-20,2023-07-15,790,702,88
100742,Beta Trading 8,2024-03-05,2024-04-03,2024-03-31,1464,1263,201
100743,Theta Solutions 35,2023-10-05,2023-10-24,2023-10-24,2250,2081,169
100744,Theta Solutions 35,2025-07-12,2025-07-30,2025-07-26,3031,2585,446
100745,Theta Solutions 35,2024-02-15,2024-03-05,2024-03-03,3621,3201,420
100746,Omicron Export 115,2023-12-02,2023-12-22,2023-12-22,2129,2011,118
100747,Omicron Export 115,2023-10-26,2023-12-16,2023-12-11,3224,2923,301
100748,Omicron Export 115,2024-04-20,2024-05-28,2024-05-25,2093,1780,313
100749,Sigma Enterprises 51,2025-01-20,2025-03-10,2025-03-09,2266,2215,51
100750,Sigma Enterprises 51,2025-08-12,2025-09-22,2025-09-18,1312,1244,68
100751,Mu Services 24,2025-06-17,2025-07-02,2025-07-03,1892,1677,215
100752,Mu Services 24,2024-01-21,2024-02-24,2024-02-20,1377,1174,203
100753,Mu Services 24,2024-03-05,2024-04-20,2024-04-25,1828,1633,195
100754,Mu Services 24,2023-04-06,2023-04-23,2023-05-22,4264,3723,541
100755,Mu Services 24,2024-02-27,2024-04-26,2024-04-23,1860,1588,272
100756,Mu Services 24,2023-03-28,2023-05-19,2023-05-18,6158,5569,589
100757,Kappa Group 84,2023-03-18,2023-05-09,2023-05-06,3591,3234,357
100758,Kappa Group 84,2023-05-14,2023-06-13,2023-06-11,3221,2774,447
100759,Kappa Group 84,2024-02-07,2024-04-06,2024-04-04,1969,1875,94
100760,Kappa Group 84,2023-10-06,2023-11-04,2023-11-03,3840,3762,78
100761,Gamma Services 118,2023-04-22,2023-05-16,2023-05-13,2309,2148,161
100762,Gamma Services 118,2024-02-21,2024-03-14,2024-03-13,3146,2933,213
100763,Gamma Services 118,2024-04-19,2024-05-20,2024-05-20,6072,5928,144
100764,Gamma Services 118,2024-12-03,2025-01-06,2025-01-01,2884,2623,261
100765,Gamma Services 118,2023-08-09,2023-09-13,2023-09-08,4379,4216,163
100766,Delta Services 98,2024-02-10,2024-03-28,2024-03-26,2156,2072,84
100767,Delta Services 98,2023-06-28,2023-07-14,2023-08-11,2958,2757,201
100768,Delta Services 98,2025-02-05,2025-03-27,2025-03-24,5124,5046,78
100769,Nu LLC 179,2023-05-05,2023-05-20,2023-05-19,2247,2203,44
100770,Nu LLC 179,2025-04-23,2025-06-02,2025-05-28,5174,4446,728
100771,Iota Industries 128,2024-08-19,2024-10-10,2024-10-10,3849,3836,13
100772,Phi LLC 44,2023-07-22,2023-09-16,2023-09-15,2325,2293,32
100773,Lambda Enterprises 58,2023-05-06,2023-05-23,2023-05-25,3758,3663,95
100774,Lambda Enterprises 58,2024-08-10,2024-09-21,2024-09-18,4167,3857,310
100775,Lambda Enterprises 58,2024-01-27,2024-03-25,2024-03-23,3746,3625,121
100776,Upsilon Solutions 25,2023-10-09,2023-11-10,2023-11-09,1115,1109,6
100777,Upsilon Solutions 25,2024-09-26,2024-11-19,2024-11-17,2127,1968,159
100778,Zeta Solutions 148,2024-05-05,2024-05-23,2024-05-20,2702,2646,56
100779,Zeta Solutions 148,2023-07-24,2023-09-18,2023-09-14,2910,2801,109
100780,Zeta Solutions 148,2025-04-01,2025-05-20,2025-05-17,3744,3305,439
100781,Zeta Solutions 148,2024-01-03,2024-02-17,2024-02-14,3213,3047,166
100782,Zeta Solutions 148,2024-08-02,2024-09-18,2024-09-16,1397,1359,38
100783,Rho Enterprises 127,2024-09-03,2024-10-02,2024-09-30,3456,3426,30
100784,Rho Enterprises 127,2024-04-28,2024-06-15,2024-06-11,3732,3172,560
100785,Rho Enterprises 127,2023-06-13,2023-07-04,2023-07-03,3671,3524,147
100786,Omega LLC 4,2023-02-27,2023-03-28,2023-03-25,4296,4067,229
100787,Omega LLC 4,2025-05-09,2025-06-04,2025-05-31,4000,3809,191
100788,Omega LLC 4,2025-01-25,2025-03-25,2025-03-21,3551,3536,15
100789,Omega LLC 4,2024-12-18,2025-01-24,2025-02-12,2915,2853,62
100790,Omega LLC 4,2025-08-29,2025-09-25,2025-09-22,1006,924,82
100791,Omega LLC 4,2023-06-29,2023-08-14,2023-08-14,3515,3392,123
100792,Zeta Import 48,2023-01-21,2023-03-10,2023-03-08,3249,2802,447
100793,Zeta Import 48,2023-07-26,2023-08-18,2023-08-17,3325,2867,458
100794,Chi Co 164,2023-03-02,2023-03-18,2023-03-13,1467,1265,202
100795,Chi Co 164,2025-03-03,2025-03-25,2025-03-23,1702,1457,245
100796,Chi Co 164,2024-01-18,2024-03-18,2024-03-31,4263,3888,375
100797,Rho LLC 89,2023-11-06,2023-12-11,2023-12-10,2952,2628,324
100798,Rho LLC 89,2024-03-23,2024-05-17,2024-06-07,3817,3635,182
100799,Rho LLC 89,2024-12-25,2025-02-13,2025-02-09,3033,2675,358
100800,Phi Services 114,2024-11-12,2025-01-03,2024-12-31,3035,2895,140
100801,Phi Services 114,2024-12-06,2025-01-08,2025-01-03,4125,4124,1
100802,Eta Solutions 166,2025-08-29,2025-10-19,2025-10-15,2380,2368,12
100803,Eta Solutions 166,2024-09-08,2024-10-13,2024-11-02,3115,3012,103
100804,Eta Solutions 166,2024-08-02,2024-08-23,2024-08-28,2445,2324,121
100805,Eta Solutions 166,2023-03-21,2023-04-20,2023-04-18,2478,2416,62
100806,Eta Solutions 166,2025-06-25,2025-07-15,2025-07-10,2628,2376,252
100807,Eta Solutions 166,2025-06-26,2025-08-01,2025-07-30,3266,3163,103
100808,Tau Tech 181,2023-03-11,2023-04-17,2023-04-17,2425,2163,262
100809,Tau Tech 181,2023-02-19,2023-03-30,2023-03-27,4506,3851,655
100810,Tau Tech 181,2025-06-24,2025-08-04,2025-08-01,1926,1825,101
100811,Tau Tech 181,2024-01-20,2024-02-10,2024-02-06,2775,2504,271
100812,Tau Tech 181,2024-12-04,2025-01-02,2025-01-02,2472,2176,296
100813,Tau Tech 181,2023-02-04,2023-03-09,2023-03-07,4736,4060,676
100814,Upsilon Services 31,2023-12-17,2024-01-11,2024-01-10,3235,2880,355
100815,Alpha LLC 122,2025-08-22,2025-09-11,2025-09-07,4238,3670,568
100816,Alpha LLC 122,2024-12-22,2025-01-07,2025-01-02,1217,1187,30
100817,Alpha LLC 122,2025-06-30,2025-08-11,2025-08-11,3320,3155,165
100818,Alpha LLC 122,2023-07-14,2023-08-24,2023-08-19,4067,3502,565
100819,Alpha LLC 122,2024-07-07,2024-08-07,2024-08-05,3098,2988,110
100820,Omicron LLC 116,2024-02-07,2024-03-29,2024-03-26,4278,4179,99
100821,Lambda LLC 126,2023-01-04,2023-02-15,2023-02-10,2379,2156,223
100822,Lambda LLC 126,2024-05-06,2024-06-02,2024-06-01,4691,4571,120
100823,Lambda LLC 126,2023-10-26,2023-11-15,2023-11-15,5758,5492,266
100824,Eta Group 157,2024-04-27,2024-06-12,2024-06-10,2564,2529,35
100825,Eta Group 157,2024-07-11,2024-08-19,2024-08-16,2465,2328,137
100826,Eta Group 157,2024-04-01,2024-04-18,2024-04-15,4744,4557,187
100827,Eta Group 157,2025-05-07,2025-06-08,2025-06-07,4895,4343,552
100828,Psi Industries 123,2023-04-10,2023-04-30,2023-04-26,2372,2225,147
100829,Psi Industries 123,2025-02-13,2025-04-06,2025-04-06,2495,2180,315
100830,Psi Industries 123,2025-04-18,2025-06-05,2025-06-01,2661,2387,274
100831,Psi Industries 123,2025-08-16,2025-09-30,2025-09-29,1386,1287,99
100832,Psi Industries 123,2023-03-22,2023-05-01,2023-05-24,1897,1887,10
100833,Psi Industries 123,2024-08-07,2024-09-24,2024-09-19,1795,1530,265
100834,Alpha Tech 119,2023-05-04,2023-06-16,2023-06-15,2078,1775,303
100835,Alpha Tech 119,2025-04-07,2025-05-04,2025-05-01,2958,2923,35
100836,Beta Enterprises 100,2024-03-21,2024-04-17,2024-05-08,3281,3208,73
100837,Beta Enterprises 100,2024-09-01,2024-10-02,2024-09-27,4860,4194,666
100838,Beta Enterprises 100,2023-03-10,2023-03-30,2023-03-27,1801,1652,149
100839,Beta Enterprises 100,2025-05-27,2025-06-28,2025-06-28,4181,3688,493
100840,Beta Enterprises 100,2024-09-30,2024-11-21,2024-11-18,2743,2697,46
100841,Beta Enterprises 100,2023-06-03,2023-06-27,2023-06-23,2940,2606,334
100842,Chi Solutions 42,2025-08-05,2025-08-26,2025-08-26,3809,3360,449
100843,Gamma Import 150,2025-06-20,2025-07-27,2025-07-25,1652,1557,95
100844,Gamma Import 150,2024-05-12,2024-07-02,2024-07-02,3458,3369,89
100845,Gamma Import 150,2024-02-17,2024-03-12,2024-03-07,3199,2866,333
100846,Gamma Import 150,2023-02-09,2023-03-21,2023-03-19,3590,3218,372
100847,Gamma Import 150,2023-02-20,2023-04-06,2023-05-05,3347,3160,187
100848,Tau Enterprises 121,2025-04-17,2025-05-21,2025-05-18,5946,5181,765
100849,Tau Enterprises 121,2024-12-02,2024-12-23,2024-12-31,2234,2189,45
100850,Tau Enterprises 121,2025-01-31,2025-03-15,2025-03-13,2362,2267,95
100851,Theta SARL 3,2024-09-11,2024-11-06,2024-11-03,2252,2181,71
100852,Theta SARL 3,2025-04-23,2025-06-03,2025-05-30,2333,2030,303
100853,Theta SARL 3,2025-04-20,2025-05-08,2025-05-07,2235,2213,22
100854,Theta SARL 3,2024-12-27,2025-02-12,2025-02-08,4426,3842,584
100855,Lambda Solutions 186,2023-06-27,2023-07-24,2023-07-23,4704,4113,591
100856,Alpha Import 194,2023-02-03,2023-03-19,2023-03-19,2315,2315,0
100857,Alpha Import 194,2025-07-29,2025-09-05,2025-08-31,2001,2001,0
100858,Delta LLC 22,2023-10-08,2023-11-15,2023-11-12,3565,3565,0
100859,Delta LLC 22,2024-06-01,2024-07-11,2024-07-06,2337,2337,0
100860,Pi LLC 103,2024-11-28,2024-12-14,2024-12-13,3759,3759,0
100861,Gamma Co 102,2024-05-15,2024-07-07,2024-07-04,3243,3243,0
100862,Gamma Co 102,2023-07-01,2023-08-15,2023-08-11,1181,1181,0
100863,Gamma Co 102,2024-07-18,2024-08-24,2024-08-22,4857,4857,0
100864,Beta Enterprises 124,2025-05-07,2025-06-07,2025-06-02,5155,5155,0
100865,Beta Enterprises 124,2025-04-30,2025-06-28,2025-06-28,2264,2264,0
100866,Iota SARL 20,2023-01-29,2023-03-09,2023-03-09,2534,2534,0
100867,Iota SARL 20,2023-06-16,2023-08-06,2023-08-05,3343,3343,0
100868,Iota SARL 20,2025-05-27,2025-06-25,2025-06-20,3401,3401,0
100869,Chi Industries 140,2024-11-24,2024-12-22,2024-12-20,3790,3790,0
100870,Chi Industries 140,2024-10-29,2024-12-09,2024-12-05,5412,5412,0
100871,Nu Industries 60,2025-06-04,2025-08-01,2025-08-01,2787,2787,0
100872,Zeta LLC 176,2025-07-22,2025-08-14,2025-08-09,2042,2042,0
100873,Zeta LLC 176,2023-06-27,2023-08-19,2023-08-19,1344,1344,0
100874,Zeta LLC 176,2023-08-18,2023-09-18,2023-09-14,2122,2122,0
100875,Zeta LLC 176,2025-04-04,2025-05-08,2025-05-03,2960,2960,0
100876,Sigma SARL 104,2024-03-09,2024-04-17,2024-04-15,5153,5153,0
100877,Sigma SARL 104,2024-04-15,2024-05-16,2024-05-15,2378,2378,0
100878,Sigma SARL 104,2024-04-22,2024-05-26,2024-05-21,3268,3268,0
100879,Phi Solutions 90,2024-08-21,2024-09-11,2024-09-11,2980,2980,0
100880,Phi Solutions 90,2024-06-07,2024-08-03,2024-08-01,4426,4426,0
100881,Phi Solutions 90,2024-07-28,2024-09-22,2024-09-18,6032,6032,0
100882,Phi Solutions 90,2024-09-15,2024-10-18,2024-10-16,2362,2362,0
100883,Beta Tech 182,2024-05-08,2024-05-27,2024-05-25,2412,2412,0
100884,Theta Co 63,2024-10-17,2024-11-21,2024-11-19,4252,4252,0
100885,Theta Co 63,2023-09-25,2023-11-20,2023-11-15,3818,3818,0
100886,Theta Co 63,2025-07-02,2025-08-27,2025-08-25,5216,5216,0
100887,Tau Import 172,2023-06-03,2023-07-21,2023-07-20,3700,3700,0
100888,Tau Import 172,2025-07-10,2025-07-28,2025-07-24,2568,2568,0
100889,Phi Export 91,2024-11-07,2024-12-12,2024-12-07,3708,3708,0
100890,Phi Export 91,2023-05-24,2023-06-09,2023-06-04,4330,4330,0
100891,Phi Export 91,2024-05-24,2024-06-26,2024-06-24,3984,3984,0
100892,Phi Export 91,2025-07-17,2025-08-27,2025-08-24,3608,3608,0
100893,Xi Import 138,2025-01-24,2025-02-10,2025-02-06,4280,4280,0
100894,Xi Import 138,2024-12-26,2025-02-15,2025-02-14,4403,4403,0
100895,Xi Import 138,2023-12-18,2024-02-16,2024-02-15,4658,4658,0
100896,Xi Import 138,2024-12-03,2025-01-21,2025-01-16,3778,3778,0
100897,Epsilon Services 93,2025-07-17,2025-09-12,2025-09-10,2799,2799,0
100898,Epsilon Services 93,2024-06-03,2024-07-07,2024-07-06,3176,3176,0
100899,Epsilon Services 93,2025-05-10,2025-07-06,2025-07-02,4447,4447,0
100900,Epsilon Services 93,2023-07-05,2023-08-07,2023-08-07,2019,2019,0
100901,Iota Export 78,2023-05-12,2023-06-12,2023-06-07,3442,3442,0
100902,Iota Export 78,2025-04-07,2025-05-27,2025-05-26,2527,2527,0
100903,Iota Export 78,2025-08-27,2025-10-24,2025-10-22,3034,3034,0
100904,Iota Export 78,2024-11-01,2024-11-21,2024-11-20,4534,4534,0
100905,Theta Export 10,2023-08-17,2023-09-20,2023-09-17,3229,3229,0
100906,Theta Export 10,2025-03-18,2025-04-23,2025-04-21,3055,3055,0
100907,Theta Export 10,2023-09-24,2023-11-15,2023-11-13,1368,1368,0
100908,Tau Enterprises 32,2025-05-21,2025-06-12,2025-06-09,3895,3895,0
100909,Tau Enterprises 32,2023-02-24,2023-04-20,2023-04-16,3774,3774,0
100910,Tau Enterprises 32,2024-08-17,2024-10-10,2024-10-10,5595,5595,0
100911,Tau Enterprises 32,2024-04-28,2024-05-25,2024-05-21,2630,2630,0
100912,Sigma Co 110,2025-06-07,2025-08-04,2025-08-01,3262,3262,0
100913,Delta Group 37,2024-02-28,2024-03-17,2024-03-16,3299,3299,0
100914,Delta Group 37,2023-05-21,2023-06-17,2023-06-15,4892,4892,0
100915,Delta Group 37,2024-02-24,2024-04-15,2024-04-12,2885,2885,0
100916,Beta Industries 152,2023-11-20,2024-01-19,2024-01-18,3334,3334,0
100917,Beta Industries 152,2025-03-08,2025-03-28,2025-03-25,3729,3729,0
100918,Sigma Enterprises 197,2024-10-08,2024-11-03,2024-11-01,3223,3223,0
100919,Sigma Enterprises 197,2024-10-11,2024-10-29,2024-10-29,2464,2464,0
100920,Sigma Enterprises 197,2024-04-07,2024-05-09,2024-05-08,3232,3232,0
100921,Gamma Enterprises 9,2024-08-13,2024-09-07,2024-09-04,4288,4288,0
100922,Gamma Enterprises 9,2025-03-15,2025-04-04,2025-04-03,1768,1768,0
100923,Lambda LLC 193,2024-10-10,2024-11-21,2024-11-18,3159,3159,0
100924,Lambda LLC 193,2024-03-15,2024-04-29,2024-04-26,2159,2159,0
100925,Lambda LLC 193,2023-01-05,2023-01-22,2023-01-18,4434,4434,0
100926,Lambda LLC 193,2023-07-24,2023-08-31,2023-08-31,1172,1172,0
100927,Iota Import 38,2025-02-14,2025-04-03,2025-04-02,2329,2329,0
100928,Iota Import 38,2023-01-19,2023-03-18,2023-03-18,3452,3452,0
100929,Iota Import 38,2024-10-03,2024-11-02,2024-11-01,4878,4878,0
100930,Xi Services 19,2023-11-16,2023-12-09,2023-12-09,2921,2921,0
100931,Xi Services 19,2024-01-28,2024-03-15,2024-03-11,2333,2333,0
100932,Xi Services 19,2023-11-10,2023-12-05,2023-12-05,5257,5257,0
100933,Delta Group 28,2023-11-02,2023-12-05,2023-12-02,1262,1262,0
100934,Eta Industries 187,2024-03-20,2024-05-17,2024-05-16,361,361,0
100935,Eta Industries 187,2023-12-17,2024-02-01,2024-01-30,3528,3528,0
100936,Eta Industries 187,2025-02-07,2025-03-06,2025-03-05,2397,2397,0
100937,Omega Services 143,2023-01-20,2023-02-18,2023-02-17,1774,1774,0
100938,Omega Services 143,2025-01-14,2025-02-06,2025-02-05,3850,3850,0
100939,Omega Services 143,2025-01-21,2025-02-06,2025-02-02,3292,3292,0
100940,Omega Services 143,2024-05-31,2024-06-25,2024-06-25,2323,2323,0
100941,Xi Enterprises 109,2024-12-29,2025-02-23,2025-02-23,1463,1463,0
100942,Xi Enterprises 109,2024-01-20,2024-03-15,2024-03-13,4046,4046,0
100943,Xi Enterprises 109,2025-02-28,2025-04-18,2025-04-14,3780,3780,0
100944,Upsilon LLC 177,2024-08-31,2024-09-18,2024-09-13,2880,2880,0
100945,Nu Industries 113,2024-10-31,2024-11-16,2024-11-16,5215,5215,0
100946,Mu Enterprises 41,2024-03-02,2024-04-14,2024-04-11,1715,1715,0
100947,Tau Co 168,2024-07-14,2024-08-14,2024-08-11,1169,1169,0
100948,Psi LLC 33,2023-07-30,2023-09-27,2023-09-22,2169,2169,0
100949,Psi LLC 33,2024-10-07,2024-10-22,2024-10-20,2945,2945,0
100950,Zeta Import 85,2024-11-08,2024-11-29,2024-11-24,3292,3292,0
100951,Zeta Import 85,2024-06-16,2024-07-18,2024-07-14,2710,2710,0
100952,Zeta Import 85,2024-09-12,2024-11-10,2024-11-09,3422,3422,0
100953,Zeta Import 85,2024-03-04,2024-03-25,2024-03-21,1498,1498,0
100954,Phi LLC 0,2023-10-17,2023-11-08,2023-11-08,4732,4732,0
100955,Upsilon Trading 11,2023-07-23,2023-09-14,2023-09-13,2901,2901,0
100956,Upsilon Trading 11,2025-03-07,2025-04-07,2025-04-03,4340,4340,0
100957,Upsilon Trading 11,2023-07-26,2023-09-01,2023-08-27,3411,3411,0
100958,Upsilon Trading 11,2024-02-24,2024-03-28,2024-03-27,3548,3548,0
100959,Pi LLC 70,2024-07-15,2024-08-30,2024-08-29,3683,3683,0
100960,Rho Tech 108,2023-12-05,2024-01-04,2024-01-04,3537,3537,0
100961,Rho Tech 108,2023-01-14,2023-03-12,2023-03-12,3771,3771,0
100962,Rho Tech 108,2025-07-17,2025-08-08,2025-08-04,4594,4594,0
100963,Rho Tech 108,2024-11-16,2025-01-01,2024-12-31,3235,3235,0
100964,Gamma Group 183,2025-03-09,2025-04-25,2025-04-25,3850,3850,0
100965,Nu LLC 23,2025-07-15,2025-08-15,2025-08-10,2892,2892,0
100966,Psi Industries 13,2024-04-12,2024-05-15,2024-05-13,4728,4728,0
100967,Psi Industries 13,2024-04-20,2024-05-08,2024-05-08,2188,2188,0
100968,Sigma Export 64,2025-06-14,2025-07-01,2025-06-29,5161,5161,0
100969,Sigma Export 64,2024-01-04,2024-03-02,2024-02-29,2951,2951,0
100970,Gamma Trading 125,2025-01-26,2025-02-17,2025-02-17,1283,1283,0
100971,Gamma Trading 125,2025-05-21,2025-06-07,2025-06-07,3153,3153,0
100972,Gamma Trading 125,2025-05-22,2025-06-14,2025-06-09,2182,2182,0
100973,Gamma Trading 125,2024-10-24,2024-11-18,2024-11-16,4008,4008,0
100974,Pi Enterprises 129,2025-07-04,2025-08-16,2025-08-12,2216,2216,0
100975,Pi Enterprises 129,2023-10-02,2023-10-22,2023-10-20,2464,2464,0
100976,Pi Enterprises 129,2025-04-14,2025-05-20,2025-05-19,732,732,0
100977,Kappa Import 192,2024-02-15,2024-03-26,2024-03-23,2457,2457,0
100978,Xi Co 162,2025-05-05,2025-06-13,2025-06-08,91,91,0
100979,Xi Co 162,2025-05-21,2025-07-05,2025-07-02,1099,1099,0
100980,Xi Co 162,2024-10-26,2024-11-20,2024-11-20,3912,3912,0
100981,Chi Services 52,2024-12-13,2024-12-31,2024-12-30,3942,3942,0
100982,Chi Services 52,2023-04-17,2023-05-28,2023-05-24,3510,3510,0
100983,Omega Solutions 87,2025-04-01,2025-05-22,2025-05-17,1839,1839,0
100984,Omega Solutions 87,2024-03-24,2024-04-19,2024-04-15,2942,2942,0
100985,Omega Solutions 87,2024-01-24,2024-03-01,2024-02-26,2995,2995,0
100986,Omega Solutions 87,2023-01-30,2023-03-29,2023-03-24,1609,1609,0
100987,Beta Enterprises 53,2024-05-09,2024-06-24,2024-06-24,4804,4804,0
100988,Beta Enterprises 53,2025-06-27,2025-08-07,2025-08-04,4052,4052,0
100989,Gamma Enterprises 154,2023-03-06,2023-04-06,2023-04-01,2734,2734,0
100990,Delta LLC 196,2023-01-13,2023-03-14,2023-03-09,3032,3032,0
100991,Delta LLC 196,2024-06-21,2024-08-11,2024-08-06,3250,3250,0
100992,Delta LLC 196,2024-08-01,2024-08-30,2024-08-25,549,549,0
100993,Epsilon Export 69,2024-06-15,2024-08-02,2024-07-28,2703,2703,0
100994,Epsilon Export 69,2024-12-18,2025-02-10,2025-02-10,2181,2181,0
100995,Epsilon Export 69,2024-03-19,2024-05-15,2024-05-10,1798,1798,0
100996,Phi Services 39,2024-05-08,2024-06-14,2024-06-09,2662,2662,0
100997,Phi Services 39,2024-11-23,2025-01-18,2025-01-15,5157,5157,0
100998,Tau Export 185,2025-05-09,2025-06-28,2025-06-24,3769,3769,0
100999,Tau Export 185,2023-02-25,2023-03-12,2023-03-07,2314,2314,0
101000,Omicron Export 27,2024-06-01,2024-07-16,2024-07-13,3687,3687,0
